YEAR,STATE,ENERGY SOURCE,NON CLEAN SOURCE,CLEAN SOURCE,GENERATION (Megawatthours)
1990,AK,Coal,1021146,0,1021146
1990,AK,Hydroelectric Conventional,0,1949042,1949042
1990,AK,Natural Gas,6932522,0,6932522
1990,AK,Petroleum,994232,0,994232
1990,AK,Total,0,11199012,11199012
1990,AK,Wind,0,0,0
1990,AK,Wood and Wood Derived Fuels,302070,0,302070
1990,AL,Coal,107316230,0,107316230
1990,AL,Hydroelectric Conventional,0,20733014,20733014
1990,AL,Natural Gas,2041428,0,2041428
1990,AL,Nuclear,0,24103764,24103764
1990,AL,Other Biomass,95006,0,95006
1990,AL,Other Gases,538952,0,538952
1990,AL,Petroleum,276178,0,276178
1990,AL,Total,0,159304266,159304266
1990,AL,Wood and Wood Derived Fuels,4199694,0,4199694
1990,AR,Coal,38415870,0,38415870
1990,AR,Hydroelectric Conventional,0,7309306,7309306
1990,AR,Natural Gas,7157146,0,7157146
1990,AR,Nuclear,0,22564106,22564106
1990,AR,Other Biomass,30778,0,30778
1990,AR,Petroleum,159958,0,159958
1990,AR,Pumped Storage,0,85944,85944
1990,AR,Total,0,78199196,78199196
1990,AR,Wood and Wood Derived Fuels,2476088,0,2476088
1990,AZ,Coal,63831220,0,63831220
1990,AZ,Hydroelectric Conventional,0,14835152,14835152
1990,AZ,Natural Gas,4667800,0,4667800
1990,AZ,Nuclear,0,41195378,41195378
1990,AZ,Petroleum,303734,0,303734
1990,AZ,Pumped Storage,0,499534,499534
1990,AZ,Total,0,125548594,125548594
1990,AZ,Wood and Wood Derived Fuels,215776,0,215776
1990,CA,Coal,5275354,0,5275354
1990,CA,Geothermal,29042508,0,29042508
1990,CA,Hydroelectric Conventional,0,47585134,47585134
1990,CA,Natural Gas,148336616,0,148336616
1990,CA,Nuclear,0,65385614,65385614
1990,CA,Other,0,0,0
1990,CA,Other Biomass,4235830,0,4235830
1990,CA,Other Gases,4293484,0,4293484
1990,CA,Petroleum,10947704,0,10947704
1990,CA,Pumped Storage,0,1972504,1972504
1990,CA,Solar Thermal and Photovoltaic,0,733336,733336
1990,CA,Total,0,331569818,331569818
1990,CA,Wind,0,5517762,5517762
1990,CA,Wood and Wood Derived Fuels,8243972,0,8243972
1990,CO,Coal,59629966,0,59629966
1990,CO,Hydroelectric Conventional,0,2839740,2839740
1990,CO,Natural Gas,2580184,0,2580184
1990,CO,Other Biomass,57980,0,57980
1990,CO,Petroleum,54780,0,54780
1990,CO,Pumped Storage,0,-66396,-66396
1990,CO,Total,0,65096254,65096254
1990,CT,Coal,7189290,0,7189290
1990,CT,Hydroelectric Conventional,0,1141238,1141238
1990,CT,Natural Gas,2502958,0,2502958
1990,CT,Nuclear,0,39552500,39552500
1990,CT,Other,0,0,0
1990,CT,Other Biomass,2146620,0,2146620
1990,CT,Other Gases,8,0,8
1990,CT,Petroleum,17748932,0,17748932
1990,CT,Pumped Storage,0,12948,12948
1990,CT,Total,0,70294494,70294494
1990,DC,Coal,0,0,0
1990,DC,Petroleum,722086,0,722086
1990,DC,Total,0,722086,722086
1990,DE,Coal,10226958,0,10226958
1990,DE,Natural Gas,1526038,0,1526038
1990,DE,Other,12630,0,12630
1990,DE,Other Gases,329762,0,329762
1990,DE,Petroleum,3587612,0,3587612
1990,DE,Total,0,15683000,15683000
1990,FL,Coal,120200514,0,120200514
1990,FL,Hydroelectric Conventional,0,349208,349208
1990,FL,Natural Gas,37285366,0,37285366
1990,FL,Nuclear,0,43559120,43559120
1990,FL,Other,2906204,0,2906204
1990,FL,Other Biomass,3346156,0,3346156
1990,FL,Petroleum,51070276,0,51070276
1990,FL,Total,0,263005106,263005106
1990,FL,Wood and Wood Derived Fuels,4288262,0,4288262
1990,GA,Coal,137091384,0,137091384
1990,GA,Hydroelectric Conventional,0,9178234,9178234
1990,GA,Natural Gas,1660360,0,1660360
1990,GA,Nuclear,0,49593768,49593768
1990,GA,Other,2,0,2
1990,GA,Other Biomass,270914,0,270914
1990,GA,Petroleum,998960,0,998960
1990,GA,Pumped Storage,0,684220,684220
1990,GA,Total,0,205372480,205372480
1990,GA,Wood and Wood Derived Fuels,5894638,0,5894638
1990,HI,Coal,4762,0,4762
1990,HI,Geothermal,0,0,0
1990,HI,Hydroelectric Conventional,0,159032,159032
1990,HI,Other Biomass,1680010,0,1680010
1990,HI,Other Gases,32326,0,32326
1990,HI,Petroleum,17471724,0,17471724
1990,HI,Total,0,19405504,19405504
1990,HI,Wind,0,57650,57650
1990,IA,Coal,51503882,0,51503882
1990,IA,Hydroelectric Conventional,0,1750228,1750228
1990,IA,Natural Gas,666780,0,666780
1990,IA,Nuclear,0,6023144,6023144
1990,IA,Other Biomass,36036,0,36036
1990,IA,Petroleum,108942,0,108942
1990,IA,Total,0,60089012,60089012
1990,ID,Coal,88742,0,88742
1990,ID,Hydroelectric Conventional,0,18229980,18229980
1990,ID,Natural Gas,111428,0,111428
1990,ID,Other,130406,0,130406
1990,ID,Petroleum,1988,0,1988
1990,ID,Total,0,19382950,19382950
1990,ID,Wood and Wood Derived Fuels,820406,0,820406
1990,IL,Coal,109932036,0,109932036
1990,IL,Hydroelectric Conventional,0,287852,287852
1990,IL,Natural Gas,2839782,0,2839782
1990,IL,Nuclear,0,143774604,143774604
1990,IL,Other Biomass,309710,0,309710
1990,IL,Other Gases,763124,0,763124
1990,IL,Petroleum,877168,0,877168
1990,IL,Total,0,258784942,258784942
1990,IL,Wood and Wood Derived Fuels,666,0,666
1990,IN,Coal,193851108,0,193851108
1990,IN,Hydroelectric Conventional,0,882042,882042
1990,IN,Natural Gas,2941674,0,2941674
1990,IN,Other Biomass,74234,0,74234
1990,IN,Other Gases,3349098,0,3349098
1990,IN,Petroleum,1736076,0,1736076
1990,IN,Total,0,202834232,202834232
1990,KS,Coal,47440516,0,47440516
1990,KS,Hydroelectric Conventional,0,26468,26468
1990,KS,Natural Gas,5005614,0,5005614
1990,KS,Nuclear,0,15748974,15748974
1990,KS,Petroleum,148052,0,148052
1990,KS,Total,0,68369714,68369714
1990,KS,Wind,0,90,90
1990,KY,Coal,141000922,0,141000922
1990,KY,Hydroelectric Conventional,0,6320766,6320766
1990,KY,Natural Gas,55592,0,55592
1990,KY,Petroleum,237292,0,237292
1990,KY,Total,0,147614572,147614572
1990,LA,Coal,35713374,0,35713374
1990,LA,Hydroelectric Conventional,0,1312984,1312984
1990,LA,Natural Gas,78949732,0,78949732
1990,LA,Nuclear,0,28393568,28393568
1990,LA,Other,2585638,0,2585638
1990,LA,Other Biomass,183292,0,183292
1990,LA,Other Gases,881400,0,881400
1990,LA,Petroleum,464196,0,464196
1990,LA,Total,0,152931260,152931260
1990,LA,Wood and Wood Derived Fuels,4447076,0,4447076
1990,MA,Coal,22731786,0,22731786
1990,MA,Hydroelectric Conventional,0,2498484,2498484
1990,MA,Natural Gas,12265404,0,12265404
1990,MA,Nuclear,0,10139240,10139240
1990,MA,Other Biomass,3121030,0,3121030
1990,MA,Other Gases,1660,0,1660
1990,MA,Petroleum,30203584,0,30203584
1990,MA,Pumped Storage,0,-1339166,-1339166
1990,MA,Total,0,79622022,79622022
1990,MA,Wood and Wood Derived Fuels,0,0,0
1990,MD,Coal,47019724,0,47019724
1990,MD,Hydroelectric Conventional,0,4597820,4597820
1990,MD,Natural Gas,3044886,0,3044886
1990,MD,Nuclear,0,2502832,2502832
1990,MD,Other Biomass,742148,0,742148
1990,MD,Other Gases,976394,0,976394
1990,MD,Petroleum,7142544,0,7142544
1990,MD,Total,0,66324584,66324584
1990,MD,Wood and Wood Derived Fuels,298236,0,298236
1990,ME,Coal,906436,0,906436
1990,ME,Hydroelectric Conventional,0,8181072,8181072
1990,ME,Natural Gas,101572,0,101572
1990,ME,Nuclear,0,9721454,9721454
1990,ME,Other Biomass,721596,0,721596
1990,ME,Petroleum,6162200,0,6162200
1990,ME,Total,0,31892028,31892028
1990,ME,Wood and Wood Derived Fuels,6097698,0,6097698
1990,MI,Coal,134133740,0,134133740
1990,MI,Hydroelectric Conventional,0,3255836,3255836
1990,MI,Natural Gas,15675912,0,15675912
1990,MI,Nuclear,0,43221000,43221000
1990,MI,Other Biomass,621684,0,621684
1990,MI,Other Gases,681898,0,681898
1990,MI,Petroleum,1723450,0,1723450
1990,MI,Pumped Storage,0,-1389972,-1389972
1990,MI,Total,0,200119474,200119474
1990,MI,Wood and Wood Derived Fuels,2195926,0,2195926
1990,MN,Coal,56352560,0,56352560
1990,MN,Hydroelectric Conventional,0,1714092,1714092
1990,MN,Natural Gas,1079678,0,1079678
1990,MN,Nuclear,0,24278604,24278604
1990,MN,Other Biomass,969622,0,969622
1990,MN,Petroleum,895628,0,895628
1990,MN,Total,0,86140752,86140752
1990,MN,Wind,0,532,532
1990,MN,Wood and Wood Derived Fuels,850036,0,850036
1990,MO,Coal,97593586,0,97593586
1990,MO,Hydroelectric Conventional,0,4384230,4384230
1990,MO,Natural Gas,624218,0,624218
1990,MO,Nuclear,0,15996078,15996078
1990,MO,Petroleum,180066,0,180066
1990,MO,Pumped Storage,0,-72518,-72518
1990,MO,Total,0,118705660,118705660
1990,MS,Coal,19053054,0,19053054
1990,MS,Natural Gas,11839328,0,11839328
1990,MS,Nuclear,0,14844262,14844262
1990,MS,Petroleum,1477942,0,1477942
1990,MS,Total,0,50402834,50402834
1990,MS,Wood and Wood Derived Fuels,3188248,0,3188248
1990,MT,Coal,30239238,0,30239238
1990,MT,Hydroelectric Conventional,0,21433634,21433634
1990,MT,Natural Gas,110510,0,110510
1990,MT,Petroleum,57964,0,57964
1990,MT,Total,0,52059544,52059544
1990,MT,Wind,0,0,0
1990,MT,Wood and Wood Derived Fuels,218198,0,218198
1990,NC,Coal,99643190,0,99643190
1990,NC,Hydroelectric Conventional,0,13638854,13638854
1990,NC,Natural Gas,406930,0,406930
1990,NC,Nuclear,0,51810638,51810638
1990,NC,Other,406812,0,406812
1990,NC,Other Biomass,52540,0,52540
1990,NC,Petroleum,656050,0,656050
1990,NC,Pumped Storage,0,360092,360092
1990,NC,Total,0,169851534,169851534
1990,NC,Wood and Wood Derived Fuels,2876428,0,2876428
1990,ND,Coal,50378006,0,50378006
1990,ND,Hydroelectric Conventional,0,3422296,3422296
1990,ND,Natural Gas,103126,0,103126
1990,ND,Petroleum,83094,0,83094
1990,ND,Total,0,53986522,53986522
1990,NE,Coal,25322300,0,25322300
1990,NE,Hydroelectric Conventional,0,2280186,2280186
1990,NE,Natural Gas,616130,0,616130
1990,NE,Nuclear,0,15022596,15022596
1990,NE,Petroleum,25962,0,25962
1990,NE,Total,0,43267174,43267174
1990,NH,Coal,5918406,0,5918406
1990,NH,Hydroelectric Conventional,0,3762174,3762174
1990,NH,Natural Gas,0,0,0
1990,NH,Nuclear,0,8161382,8161382
1990,NH,Other Biomass,295048,0,295048
1990,NH,Petroleum,4692986,0,4692986
1990,NH,Total,0,24810392,24810392
1990,NH,Wood and Wood Derived Fuels,1980396,0,1980396
1990,NJ,Coal,14115640,0,14115640
1990,NJ,Hydroelectric Conventional,0,62702,62702
1990,NJ,Natural Gas,13828650,0,13828650
1990,NJ,Nuclear,0,47540774,47540774
1990,NJ,Other Biomass,492116,0,492116
1990,NJ,Petroleum,4189938,0,4189938
1990,NJ,Pumped Storage,0,-299094,-299094
1990,NJ,Total,0,79937668,79937668
1990,NJ,Wood and Wood Derived Fuels,6942,0,6942
1990,NM,Coal,51653856,0,51653856
1990,NM,Hydroelectric Conventional,0,410870,410870
1990,NM,Natural Gas,5476174,0,5476174
1990,NM,Other Biomass,28256,0,28256
1990,NM,Petroleum,71252,0,71252
1990,NM,Total,0,57640408,57640408
1990,NV,Coal,30106554,0,30106554
1990,NV,Geothermal,1522384,0,1522384
1990,NV,Hydroelectric Conventional,0,3470162,3470162
1990,NV,Natural Gas,4434054,0,4434054
1990,NV,Petroleum,568216,0,568216
1990,NV,Total,0,40101370,40101370
1990,NY,Coal,51826094,0,51826094
1990,NY,Hydroelectric Conventional,0,56376444,56376444
1990,NY,Natural Gas,45448670,0,45448670
1990,NY,Nuclear,0,47246712,47246712
1990,NY,Other Biomass,3137958,0,3137958
1990,NY,Other Gases,178068,0,178068
1990,NY,Petroleum,67769710,0,67769710
1990,NY,Pumped Storage,0,-2108190,-2108190
1990,NY,Total,0,270691384,270691384
1990,NY,Wood and Wood Derived Fuels,815918,0,815918
1990,OH,Coal,231665300,0,231665300
1990,OH,Hydroelectric Conventional,0,362790,362790
1990,OH,Natural Gas,483170,0,483170
1990,OH,Nuclear,0,21327794,21327794
1990,OH,Other Biomass,608570,0,608570
1990,OH,Other Gases,128318,0,128318
1990,OH,Petroleum,748962,0,748962
1990,OH,Total,0,255961054,255961054
1990,OH,Wood and Wood Derived Fuels,636150,0,636150
1990,OK,Coal,51310694,0,51310694
1990,OK,Hydroelectric Conventional,0,5461188,5461188
1990,OK,Natural Gas,36473532,0,36473532
1990,OK,Other Biomass,3560,0,3560
1990,OK,Other Gases,177940,0,177940
1990,OK,Petroleum,153894,0,153894
1990,OK,Pumped Storage,0,39528,39528
1990,OK,Total,0,94158262,94158262
1990,OK,Wood and Wood Derived Fuels,537926,0,537926
1990,OR,Coal,2634688,0,2634688
1990,OR,Hydroelectric Conventional,0,82480734,82480734
1990,OR,Natural Gas,1638656,0,1638656
1990,OR,Nuclear,0,12147592,12147592
1990,OR,Other Biomass,180974,0,180974
1990,OR,Petroleum,55554,0,55554
1990,OR,Total,0,100744472,100744472
1990,OR,Wind,0,1078,1078
1990,OR,Wood and Wood Derived Fuels,1605196,0,1605196
1990,PA,Coal,213354310,0,213354310
1990,PA,Hydroelectric Conventional,0,5738384,5738384
1990,PA,Natural Gas,5667764,0,5667764
1990,PA,Nuclear,0,115574102,115574102
1990,PA,Other,1464,0,1464
1990,PA,Other Biomass,600218,0,600218
1990,PA,Other Gases,1683208,0,1683208
1990,PA,Petroleum,9309044,0,9309044
1990,PA,Pumped Storage,0,-1758498,-1758498
1990,PA,Total,0,351246622,351246622
1990,PA,Wood and Wood Derived Fuels,1076626,0,1076626
1990,RI,Coal,0,0,0
1990,RI,Hydroelectric Conventional,0,19892,19892
1990,RI,Natural Gas,1753886,0,1753886
1990,RI,Other Biomass,69512,0,69512
1990,RI,Petroleum,371342,0,371342
1990,RI,Total,0,2214632,2214632
1990,SC,Coal,46823734,0,46823734
1990,SC,Hydroelectric Conventional,0,6596132,6596132
1990,SC,Natural Gas,1575070,0,1575070
1990,SC,Nuclear,0,85761338,85761338
1990,SC,Other Biomass,99122,0,99122
1990,SC,Petroleum,345150,0,345150
1990,SC,Pumped Storage,0,-1012778,-1012778
1990,SC,Total,0,142726348,142726348
1990,SC,Wood and Wood Derived Fuels,2538580,0,2538580
1990,SD,Coal,4945028,0,4945028
1990,SD,Hydroelectric Conventional,0,7868804,7868804
1990,SD,Natural Gas,24816,0,24816
1990,SD,Petroleum,16298,0,16298
1990,SD,Total,0,12854946,12854946
1990,TN,Coal,103651212,0,103651212
1990,TN,Hydroelectric Conventional,0,20030726,20030726
1990,TN,Natural Gas,448292,0,448292
1990,TN,Nuclear,0,28005182,28005182
1990,TN,Other,90000,0,90000
1990,TN,Other Biomass,89838,0,89838
1990,TN,Other Gases,8420,0,8420
1990,TN,Petroleum,274134,0,274134
1990,TN,Pumped Storage,0,-956302,-956302
1990,TN,Total,0,152375218,152375218
1990,TN,Wood and Wood Derived Fuels,733716,0,733716
1990,TX,Coal,241842792,0,241842792
1990,TX,Hydroelectric Conventional,0,3587250,3587250
1990,TX,Natural Gas,272468650,0,272468650
1990,TX,Nuclear,0,31718516,31718516
1990,TX,Other,977462,0,977462
1990,TX,Other Biomass,666264,0,666264
1990,TX,Other Gases,5995018,0,5995018
1990,TX,Petroleum,3655606,0,3655606
1990,TX,Solar Thermal and Photovoltaic,0,770,770
1990,TX,Total,0,563119270,563119270
1990,TX,Wood and Wood Derived Fuels,2206942,0,2206942
1990,UT,Coal,63045852,0,63045852
1990,UT,Geothermal,303650,0,303650
1990,UT,Hydroelectric Conventional,0,1016886,1016886
1990,UT,Natural Gas,292976,0,292976
1990,UT,Other Gases,364010,0,364010
1990,UT,Petroleum,103704,0,103704
1990,UT,Pumped Storage,0,0,0
1990,UT,Total,0,65127078,65127078
1990,VA,Coal,47799804,0,47799804
1990,VA,Hydroelectric Conventional,0,2618998,2618998
1990,VA,Natural Gas,2269618,0,2269618
1990,VA,Nuclear,0,47640304,47640304
1990,VA,Other Biomass,1241588,0,1241588
1990,VA,Petroleum,2876528,0,2876528
1990,VA,Pumped Storage,0,-1667338,-1667338
1990,VA,Solar Thermal and Photovoltaic,0,68,68
1990,VA,Total,0,105128916,105128916
1990,VA,Wood and Wood Derived Fuels,2349346,0,2349346
1990,VT,Hydroelectric Conventional,0,2730062,2730062
1990,VT,Natural Gas,130562,0,130562
1990,VT,Nuclear,0,7232536,7232536
1990,VT,Petroleum,5086,0,5086
1990,VT,Total,0,10328216,10328216
1990,VT,Wind,0,0,0
1990,VT,Wood and Wood Derived Fuels,229970,0,229970
1990,WA,Coal,14780558,0,14780558
1990,WA,Hydroelectric Conventional,0,174933416,174933416
1990,WA,Natural Gas,576116,0,576116
1990,WA,Nuclear,0,11484054,11484054
1990,WA,Other,7500,0,7500
1990,WA,Other Biomass,12998,0,12998
1990,WA,Other Gases,16920,0,16920
1990,WA,Petroleum,85962,0,85962
1990,WA,Pumped Storage,0,0,0
1990,WA,Total,0,204143066,204143066
1990,WA,Wood and Wood Derived Fuels,2245542,0,2245542
1990,WI,Coal,66337882,0,66337882
1990,WI,Hydroelectric Conventional,0,4028824,4028824
1990,WI,Natural Gas,694408,0,694408
1990,WI,Nuclear,0,22451826,22451826
1990,WI,Other Biomass,299540,0,299540
1990,WI,Petroleum,358914,0,358914
1990,WI,Total,0,95537714,95537714
1990,WI,Wind,0,88,88
1990,WI,Wood and Wood Derived Fuels,1366232,0,1366232
1990,WV,Coal,155286732,0,155286732
1990,WV,Hydroelectric Conventional,0,2590102,2590102
1990,WV,Natural Gas,180126,0,180126
1990,WV,Other,22414,0,22414
1990,WV,Other Gases,348364,0,348364
1990,WV,Petroleum,651350,0,651350
1990,WV,Total,0,159079088,159079088
1990,WY,Coal,77816934,0,77816934
1990,WY,Hydroelectric Conventional,0,1289226,1289226
1990,WY,Natural Gas,536404,0,536404
1990,WY,Other,90792,0,90792
1990,WY,Other Gases,17284,0,17284
1990,WY,Petroleum,98410,0,98410
1990,WY,Total,0,79949930,79949930
1990,WY,Wood and Wood Derived Fuels,100880,0,100880
1991,AK,Coal,1041028,0,1041028
1991,AK,Hydroelectric Conventional,0,1792226,1792226
1991,AK,Natural Gas,6638790,0,6638790
1991,AK,Petroleum,1026850,0,1026850
1991,AK,Total,0,10779656,10779656
1991,AK,Wind,0,0,0
1991,AK,Wood and Wood Derived Fuels,280762,0,280762
1991,AL,Coal,116445684,0,116445684
1991,AL,Hydroelectric Conventional,0,21515446,21515446
1991,AL,Natural Gas,2445000,0,2445000
1991,AL,Nuclear,0,31749274,31749274
1991,AL,Other Biomass,62660,0,62660
1991,AL,Other Gases,586412,0,586412
1991,AL,Petroleum,335648,0,335648
1991,AL,Total,0,177573224,177573224
1991,AL,Wood and Wood Derived Fuels,4433100,0,4433100
1991,AR,Coal,39289424,0,39289424
1991,AR,Hydroelectric Conventional,0,7093932,7093932
1991,AR,Natural Gas,6649772,0,6649772
1991,AR,Nuclear,0,25323586,25323586
1991,AR,Other Biomass,33226,0,33226
1991,AR,Petroleum,136514,0,136514
1991,AR,Pumped Storage,0,28206,28206
1991,AR,Total,0,81302488,81302488
1991,AR,Wood and Wood Derived Fuels,2747828,0,2747828
1991,AZ,Coal,65115496,0,65115496
1991,AZ,Hydroelectric Conventional,0,13471080,13471080
1991,AZ,Natural Gas,4452776,0,4452776
1991,AZ,Nuclear,0,50191552,50191552
1991,AZ,Petroleum,234798,0,234798
1991,AZ,Pumped Storage,0,725824,725824
1991,AZ,Total,0,134405102,134405102
1991,AZ,Wood and Wood Derived Fuels,213576,0,213576
1991,CA,Coal,5264838,0,5264838
1991,CA,Geothermal,29569592,0,29569592
1991,CA,Hydroelectric Conventional,0,43914128,43914128
1991,CA,Natural Gas,148012320,0,148012320
1991,CA,Nuclear,0,63083598,63083598
1991,CA,Other,10224,0,10224
1991,CA,Other Biomass,4942800,0,4942800
1991,CA,Other Gases,3956806,0,3956806
1991,CA,Petroleum,3940238,0,3940238
1991,CA,Pumped Storage,0,199720,199720
1991,CA,Solar Thermal and Photovoltaic,0,942722,942722
1991,CA,Total,0,317895284,317895284
1991,CA,Wind,0,5829010,5829010
1991,CA,Wood and Wood Derived Fuels,8229288,0,8229288
1991,CO,Coal,58268020,0,58268020
1991,CO,Hydroelectric Conventional,0,3588580,3588580
1991,CO,Natural Gas,2629362,0,2629362
1991,CO,Other Biomass,117664,0,117664
1991,CO,Petroleum,75820,0,75820
1991,CO,Pumped Storage,0,-36260,-36260
1991,CO,Total,0,64643186,64643186
1991,CT,Coal,7266854,0,7266854
1991,CT,Hydroelectric Conventional,0,866676,866676
1991,CT,Natural Gas,3143712,0,3143712
1991,CT,Nuclear,0,24485822,24485822
1991,CT,Other,0,0,0
1991,CT,Other Biomass,2325242,0,2325242
1991,CT,Other Gases,5292,0,5292
1991,CT,Petroleum,15986448,0,15986448
1991,CT,Pumped Storage,0,-7112,-7112
1991,CT,Total,0,54072934,54072934
1991,DC,Coal,0,0,0
1991,DC,Petroleum,359628,0,359628
1991,DC,Total,0,359628,359628
1991,DE,Coal,9641518,0,9641518
1991,DE,Natural Gas,2220472,0,2220472
1991,DE,Other,12630,0,12630
1991,DE,Other Gases,0,0,0
1991,DE,Petroleum,3801644,0,3801644
1991,DE,Total,0,15676264,15676264
1991,FL,Coal,124026968,0,124026968
1991,FL,Hydroelectric Conventional,0,526132,526132
1991,FL,Natural Gas,39517620,0,39517620
1991,FL,Nuclear,0,41015138,41015138
1991,FL,Other,3835078,0,3835078
1991,FL,Other Biomass,4519684,0,4519684
1991,FL,Other Gases,20584,0,20584
1991,FL,Petroleum,61199918,0,61199918
1991,FL,Total,0,278833378,278833378
1991,FL,Wood and Wood Derived Fuels,4172256,0,4172256
1991,GA,Coal,122068144,0,122068144
1991,GA,Hydroelectric Conventional,0,8464116,8464116
1991,GA,Natural Gas,1619652,0,1619652
1991,GA,Nuclear,0,52032046,52032046
1991,GA,Other,862,0,862
1991,GA,Other Biomass,131576,0,131576
1991,GA,Petroleum,1082064,0,1082064
1991,GA,Pumped Storage,0,864582,864582
1991,GA,Total,0,192346262,192346262
1991,GA,Wood and Wood Derived Fuels,6083220,0,6083220
1991,HI,Coal,15224,0,15224
1991,HI,Hydroelectric Conventional,0,141976,141976
1991,HI,Other Biomass,1646164,0,1646164
1991,HI,Other Gases,102958,0,102958
1991,HI,Petroleum,15428906,0,15428906
1991,HI,Total,0,17406470,17406470
1991,HI,Wind,0,71242,71242
1991,IA,Coal,53513542,0,53513542
1991,IA,Hydroelectric Conventional,0,1802222,1802222
1991,IA,Natural Gas,776008,0,776008
1991,IA,Nuclear,0,8293622,8293622
1991,IA,Other Biomass,50534,0,50534
1991,IA,Petroleum,99784,0,99784
1991,IA,Total,0,64535712,64535712
1991,ID,Coal,32718,0,32718
1991,ID,Hydroelectric Conventional,0,17490558,17490558
1991,ID,Natural Gas,214486,0,214486
1991,ID,Other,123896,0,123896
1991,ID,Other Biomass,19568,0,19568
1991,ID,Petroleum,722,0,722
1991,ID,Total,0,18857238,18857238
1991,ID,Wood and Wood Derived Fuels,975290,0,975290
1991,IL,Coal,110120340,0,110120340
1991,IL,Hydroelectric Conventional,0,268914,268914
1991,IL,Natural Gas,3471740,0,3471740
1991,IL,Nuclear,0,143732182,143732182
1991,IL,Other Biomass,364110,0,364110
1991,IL,Other Gases,770762,0,770762
1991,IL,Petroleum,1820220,0,1820220
1991,IL,Total,0,260548690,260548690
1991,IL,Wood and Wood Derived Fuels,422,0,422
1991,IN,Coal,194914454,0,194914454
1991,IN,Hydroelectric Conventional,0,798102,798102
1991,IN,Natural Gas,2909496,0,2909496
1991,IN,Other Biomass,66228,0,66228
1991,IN,Other Gases,4215612,0,4215612
1991,IN,Petroleum,1058706,0,1058706
1991,IN,Total,0,203962598,203962598
1991,KS,Coal,46870016,0,46870016
1991,KS,Hydroelectric Conventional,0,21134,21134
1991,KS,Natural Gas,6531058,0,6531058
1991,KS,Nuclear,0,11717226,11717226
1991,KS,Petroleum,121968,0,121968
1991,KS,Total,0,65261486,65261486
1991,KS,Wind,0,84,84
1991,KY,Coal,143427702,0,143427702
1991,KY,Hydroelectric Conventional,0,7315602,7315602
1991,KY,Natural Gas,43742,0,43742
1991,KY,Petroleum,223116,0,223116
1991,KY,Total,0,151010162,151010162
1991,LA,Coal,37936958,0,37936958
1991,LA,Hydroelectric Conventional,0,1312984,1312984
1991,LA,Natural Gas,72726762,0,72726762
1991,LA,Nuclear,0,27912392,27912392
1991,LA,Other,3166106,0,3166106
1991,LA,Other Biomass,183322,0,183322
1991,LA,Other Gases,1911200,0,1911200
1991,LA,Petroleum,111520,0,111520
1991,LA,Total,0,149945386,149945386
1991,LA,Wood and Wood Derived Fuels,4684142,0,4684142
1991,MA,Coal,23971186,0,23971186
1991,MA,Hydroelectric Conventional,0,2229858,2229858
1991,MA,Natural Gas,12659724,0,12659724
1991,MA,Nuclear,0,8833222,8833222
1991,MA,Other Biomass,3269302,0,3269302
1991,MA,Other Gases,1600,0,1600
1991,MA,Petroleum,32319650,0,32319650
1991,MA,Pumped Storage,0,-1244960,-1244960
1991,MA,Total,0,82039582,82039582
1991,MD,Coal,45671342,0,45671342
1991,MD,Hydroelectric Conventional,0,2814574,2814574
1991,MD,Natural Gas,3034926,0,3034926
1991,MD,Nuclear,0,18072200,18072200
1991,MD,Other Biomass,673102,0,673102
1991,MD,Other Gases,957408,0,957408
1991,MD,Petroleum,8157012,0,8157012
1991,MD,Total,0,79701768,79701768
1991,MD,Wood and Wood Derived Fuels,321204,0,321204
1991,ME,Coal,1715920,0,1715920
1991,ME,Hydroelectric Conventional,0,7634462,7634462
1991,ME,Natural Gas,98202,0,98202
1991,ME,Nuclear,0,12528732,12528732
1991,ME,Other Biomass,768838,0,768838
1991,ME,Petroleum,4304418,0,4304418
1991,ME,Total,0,34689566,34689566
1991,ME,Wood and Wood Derived Fuels,7638994,0,7638994
1991,MI,Coal,133756446,0,133756446
1991,MI,Hydroelectric Conventional,0,3503336,3503336
1991,MI,Natural Gas,16998156,0,16998156
1991,MI,Nuclear,0,54042428,54042428
1991,MI,Other,56442,0,56442
1991,MI,Other Biomass,1009956,0,1009956
1991,MI,Other Gases,435658,0,435658
1991,MI,Petroleum,1317134,0,1317134
1991,MI,Pumped Storage,0,-1591570,-1591570
1991,MI,Total,0,211956248,211956248
1991,MI,Wood and Wood Derived Fuels,2428262,0,2428262
1991,MN,Coal,53567626,0,53567626
1991,MN,Hydroelectric Conventional,0,2074184,2074184
1991,MN,Natural Gas,1607880,0,1607880
1991,MN,Nuclear,0,24118110,24118110
1991,MN,Other Biomass,879622,0,879622
1991,MN,Petroleum,1167394,0,1167394
1991,MN,Total,0,84264220,84264220
1991,MN,Wind,0,474,474
1991,MN,Wood and Wood Derived Fuels,848930,0,848930
1991,MO,Coal,96423384,0,96423384
1991,MO,Hydroelectric Conventional,0,2238778,2238778
1991,MO,Natural Gas,2186002,0,2186002
1991,MO,Nuclear,0,19958742,19958742
1991,MO,Petroleum,238290,0,238290
1991,MO,Pumped Storage,0,-95744,-95744
1991,MO,Total,0,120949452,120949452
1991,MS,Coal,17580530,0,17580530
1991,MS,Natural Gas,11437872,0,11437872
1991,MS,Nuclear,0,18265866,18265866
1991,MS,Petroleum,792376,0,792376
1991,MS,Total,0,51753232,51753232
1991,MS,Wood and Wood Derived Fuels,3676588,0,3676588
1991,MT,Coal,32865040,0,32865040
1991,MT,Hydroelectric Conventional,0,23940014,23940014
1991,MT,Natural Gas,64688,0,64688
1991,MT,Petroleum,39308,0,39308
1991,MT,Total,0,57106296,57106296
1991,MT,Wind,0,0,0
1991,MT,Wood and Wood Derived Fuels,197246,0,197246
1991,NC,Coal,101534376,0,101534376
1991,NC,Hydroelectric Conventional,0,11700240,11700240
1991,NC,Natural Gas,771814,0,771814
1991,NC,Nuclear,0,60624850,60624850
1991,NC,Other,453852,0,453852
1991,NC,Other Biomass,88256,0,88256
1991,NC,Petroleum,551570,0,551570
1991,NC,Pumped Storage,0,432864,432864
1991,NC,Total,0,178750568,178750568
1991,NC,Wood and Wood Derived Fuels,2592746,0,2592746
1991,ND,Coal,51657494,0,51657494
1991,ND,Hydroelectric Conventional,0,3513368,3513368
1991,ND,Natural Gas,1880,0,1880
1991,ND,Other Gases,80262,0,80262
1991,ND,Petroleum,105292,0,105292
1991,ND,Total,0,55358296,55358296
1991,NE,Coal,27182456,0,27182456
1991,NE,Hydroelectric Conventional,0,2089342,2089342
1991,NE,Natural Gas,606654,0,606654
1991,NE,Nuclear,0,16095324,16095324
1991,NE,Petroleum,26918,0,26918
1991,NE,Total,0,46000694,46000694
1991,NH,Coal,6336108,0,6336108
1991,NH,Hydroelectric Conventional,0,3170572,3170572
1991,NH,Natural Gas,-2,0,-2
1991,NH,Nuclear,0,13575702,13575702
1991,NH,Other Biomass,282864,0,282864
1991,NH,Petroleum,3184350,0,3184350
1991,NH,Total,0,28442682,28442682
1991,NH,Wood and Wood Derived Fuels,1893088,0,1893088
1991,NJ,Coal,10474264,0,10474264
1991,NJ,Hydroelectric Conventional,0,43196,43196
1991,NJ,Natural Gas,21185814,0,21185814
1991,NJ,Nuclear,0,49613212,49613212
1991,NJ,Other Biomass,1609530,0,1609530
1991,NJ,Other Gases,135088,0,135088
1991,NJ,Petroleum,4302196,0,4302196
1991,NJ,Pumped Storage,0,-310368,-310368
1991,NJ,Total,0,87052932,87052932
1991,NM,Coal,44258624,0,44258624
1991,NM,Hydroelectric Conventional,0,474216,474216
1991,NM,Natural Gas,5727324,0,5727324
1991,NM,Other Biomass,28256,0,28256
1991,NM,Petroleum,66024,0,66024
1991,NM,Total,0,50554444,50554444
1991,NV,Coal,32731460,0,32731460
1991,NV,Geothermal,1990816,0,1990816
1991,NV,Hydroelectric Conventional,0,4730100,4730100
1991,NV,Natural Gas,4189942,0,4189942
1991,NV,Other,3136,0,3136
1991,NV,Petroleum,484954,0,484954
1991,NV,Total,0,44130408,44130408
1991,NY,Coal,53319902,0,53319902
1991,NY,Hydroelectric Conventional,0,54344240,54344240
1991,NY,Natural Gas,46148054,0,46148054
1991,NY,Nuclear,0,56896586,56896586
1991,NY,Other Biomass,3320728,0,3320728
1991,NY,Other Gases,103040,0,103040
1991,NY,Petroleum,56441110,0,56441110
1991,NY,Pumped Storage,0,-2014538,-2014538
1991,NY,Total,0,269200998,269200998
1991,NY,Wood and Wood Derived Fuels,641876,0,641876
1991,OH,Coal,235004710,0,235004710
1991,OH,Hydroelectric Conventional,0,308448,308448
1991,OH,Natural Gas,729132,0,729132
1991,OH,Nuclear,0,29665578,29665578
1991,OH,Other Biomass,648956,0,648956
1991,OH,Other Gases,114624,0,114624
1991,OH,Petroleum,855484,0,855484
1991,OH,Total,0,268072994,268072994
1991,OH,Wood and Wood Derived Fuels,746062,0,746062
1991,OK,Coal,56809278,0,56809278
1991,OK,Hydroelectric Conventional,0,3844274,3844274
1991,OK,Natural Gas,36833742,0,36833742
1991,OK,Other Biomass,0,0,0
1991,OK,Other Gases,213240,0,213240
1991,OK,Petroleum,92138,0,92138
1991,OK,Pumped Storage,0,-130704,-130704
1991,OK,Total,0,98198234,98198234
1991,OK,Wood and Wood Derived Fuels,536266,0,536266
1991,OR,Coal,5628398,0,5628398
1991,OR,Hydroelectric Conventional,0,82176674,82176674
1991,OR,Natural Gas,2446308,0,2446308
1991,OR,Nuclear,0,2930736,2930736
1991,OR,Other Biomass,182856,0,182856
1991,OR,Petroleum,22000,0,22000
1991,OR,Total,0,94889778,94889778
1991,OR,Wind,0,1078,1078
1991,OR,Wood and Wood Derived Fuels,1501728,0,1501728
1991,PA,Coal,212057750,0,212057750
1991,PA,Hydroelectric Conventional,0,3840716,3840716
1991,PA,Natural Gas,4217778,0,4217778
1991,PA,Nuclear,0,114951342,114951342
1991,PA,Other,214744,0,214744
1991,PA,Other Biomass,1341650,0,1341650
1991,PA,Other Gases,1442102,0,1442102
1991,PA,Petroleum,8251724,0,8251724
1991,PA,Pumped Storage,0,-1926290,-1926290
1991,PA,Total,0,345525418,345525418
1991,PA,Wood and Wood Derived Fuels,1133902,0,1133902
1991,RI,Coal,0,0,0
1991,RI,Hydroelectric Conventional,0,19892,19892
1991,RI,Natural Gas,5498134,0,5498134
1991,RI,Other Biomass,144310,0,144310
1991,RI,Petroleum,189302,0,189302
1991,RI,Total,0,5851638,5851638
1991,SC,Coal,47642670,0,47642670
1991,SC,Hydroelectric Conventional,0,6222636,6222636
1991,SC,Natural Gas,2163272,0,2163272
1991,SC,Nuclear,0,86216146,86216146
1991,SC,Other,15890,0,15890
1991,SC,Other Biomass,118822,0,118822
1991,SC,Other Gases,11642,0,11642
1991,SC,Petroleum,361778,0,361778
1991,SC,Pumped Storage,0,-1148514,-1148514
1991,SC,Total,0,144360014,144360014
1991,SC,Wood and Wood Derived Fuels,2755672,0,2755672
1991,SD,Coal,5454174,0,5454174
1991,SD,Hydroelectric Conventional,0,7656232,7656232
1991,SD,Natural Gas,18072,0,18072
1991,SD,Petroleum,16854,0,16854
1991,SD,Total,0,13145332,13145332
1991,TN,Coal,96473466,0,96473466
1991,TN,Hydroelectric Conventional,0,21745888,21745888
1991,TN,Natural Gas,394520,0,394520
1991,TN,Nuclear,0,33173488,33173488
1991,TN,Other,77852,0,77852
1991,TN,Other Biomass,72708,0,72708
1991,TN,Other Gases,6306,0,6306
1991,TN,Petroleum,344530,0,344530
1991,TN,Pumped Storage,0,-752676,-752676
1991,TN,Total,0,152385612,152385612
1991,TN,Wood and Wood Derived Fuels,849530,0,849530
1991,TX,Coal,241690102,0,241690102
1991,TX,Hydroelectric Conventional,0,4449162,4449162
1991,TX,Natural Gas,272885786,0,272885786
1991,TX,Nuclear,0,39599734,39599734
1991,TX,Other,1411602,0,1411602
1991,TX,Other Biomass,660058,0,660058
1991,TX,Other Gases,6641070,0,6641070
1991,TX,Petroleum,2985990,0,2985990
1991,TX,Solar Thermal and Photovoltaic,0,742,742
1991,TX,Total,0,572657416,572657416
1991,TX,Wood and Wood Derived Fuels,2333170,0,2333170
1991,UT,Coal,57775200,0,57775200
1991,UT,Geothermal,372482,0,372482
1991,UT,Hydroelectric Conventional,0,1253930,1253930
1991,UT,Natural Gas,1099968,0,1099968
1991,UT,Other Gases,407604,0,407604
1991,UT,Petroleum,102628,0,102628
1991,UT,Pumped Storage,0,0,0
1991,UT,Total,0,61011812,61011812
1991,VA,Coal,49642782,0,49642782
1991,VA,Hydroelectric Conventional,0,2160110,2160110
1991,VA,Natural Gas,3461774,0,3461774
1991,VA,Nuclear,0,47772536,47772536
1991,VA,Other Biomass,1402258,0,1402258
1991,VA,Petroleum,4707992,0,4707992
1991,VA,Pumped Storage,0,-2075330,-2075330
1991,VA,Solar Thermal and Photovoltaic,0,66,66
1991,VA,Total,0,109458188,109458188
1991,VA,Wood and Wood Derived Fuels,2386000,0,2386000
1991,VT,Hydroelectric Conventional,0,2105438,2105438
1991,VT,Natural Gas,190682,0,190682
1991,VT,Nuclear,0,8216628,8216628
1991,VT,Petroleum,10488,0,10488
1991,VT,Total,0,10775970,10775970
1991,VT,Wind,0,0,0
1991,VT,Wood and Wood Derived Fuels,252734,0,252734
1991,WA,Coal,15889558,0,15889558
1991,WA,Hydroelectric Conventional,0,178684794,178684794
1991,WA,Natural Gas,920848,0,920848
1991,WA,Nuclear,0,8459736,8459736
1991,WA,Other,6,0,6
1991,WA,Other Biomass,93266,0,93266
1991,WA,Other Gases,194934,0,194934
1991,WA,Petroleum,62328,0,62328
1991,WA,Pumped Storage,0,0,0
1991,WA,Total,0,205741124,205741124
1991,WA,Wood and Wood Derived Fuels,1435654,0,1435654
1991,WI,Coal,68974018,0,68974018
1991,WI,Hydroelectric Conventional,0,5033266,5033266
1991,WI,Natural Gas,763180,0,763180
1991,WI,Nuclear,0,21982838,21982838
1991,WI,Other Biomass,271376,0,271376
1991,WI,Petroleum,328486,0,328486
1991,WI,Total,0,98713474,98713474
1991,WI,Wind,0,12,12
1991,WI,Wood and Wood Derived Fuels,1360298,0,1360298
1991,WV,Coal,143735616,0,143735616
1991,WV,Hydroelectric Conventional,0,2130770,2130770
1991,WV,Natural Gas,117616,0,117616
1991,WV,Other,396,0,396
1991,WV,Other Gases,356978,0,356978
1991,WV,Petroleum,506094,0,506094
1991,WV,Total,0,146847470,146847470
1991,WY,Coal,76162690,0,76162690
1991,WY,Hydroelectric Conventional,0,1471864,1471864
1991,WY,Natural Gas,643526,0,643526
1991,WY,Other,94982,0,94982
1991,WY,Petroleum,122834,0,122834
1991,WY,Total,0,78596776,78596776
1991,WY,Wood and Wood Derived Fuels,100880,0,100880
1992,AK,Coal,991590,0,991590
1992,AK,Hydroelectric Conventional,0,1836240,1836240
1992,AK,Natural Gas,6428660,0,6428660
1992,AK,Other Biomass,32590,0,32590
1992,AK,Petroleum,1043900,0,1043900
1992,AK,Total,0,10596848,10596848
1992,AK,Wind,0,0,0
1992,AK,Wood and Wood Derived Fuels,263868,0,263868
1992,AL,Coal,122321342,0,122321342
1992,AL,Hydroelectric Conventional,0,20520046,20520046
1992,AL,Natural Gas,2792126,0,2792126
1992,AL,Nuclear,0,38794872,38794872
1992,AL,Other Biomass,57580,0,57580
1992,AL,Other Gases,657440,0,657440
1992,AL,Petroleum,389732,0,389732
1992,AL,Total,0,190468844,190468844
1992,AL,Wood and Wood Derived Fuels,4935706,0,4935706
1992,AR,Coal,40187200,0,40187200
1992,AR,Hydroelectric Conventional,0,6754510,6754510
1992,AR,Natural Gas,6853264,0,6853264
1992,AR,Nuclear,0,22651322,22651322
1992,AR,Other Biomass,29966,0,29966
1992,AR,Petroleum,105336,0,105336
1992,AR,Pumped Storage,0,5384,5384
1992,AR,Total,0,79492202,79492202
1992,AR,Wood and Wood Derived Fuels,2905220,0,2905220
1992,AZ,Coal,69634176,0,69634176
1992,AZ,Hydroelectric Conventional,0,13241514,13241514
1992,AZ,Natural Gas,5950730,0,5950730
1992,AZ,Nuclear,0,51217412,51217412
1992,AZ,Petroleum,203830,0,203830
1992,AZ,Pumped Storage,0,580930,580930
1992,AZ,Total,0,141105454,141105454
1992,AZ,Wood and Wood Derived Fuels,276862,0,276862
1992,CA,Coal,6599020,0,6599020
1992,CA,Geothermal,29542974,0,29542974
1992,CA,Hydroelectric Conventional,0,40334820,40334820
1992,CA,Natural Gas,177409574,0,177409574
1992,CA,Nuclear,0,70488672,70488672
1992,CA,Other,20422,0,20422
1992,CA,Other Biomass,5566712,0,5566712
1992,CA,Other Gases,5429376,0,5429376
1992,CA,Petroleum,3897078,0,3897078
1992,CA,Pumped Storage,0,-8990,-8990
1992,CA,Solar Thermal and Photovoltaic,0,798520,798520
1992,CA,Total,0,354310918,354310918
1992,CA,Wind,0,5727998,5727998
1992,CA,Wood and Wood Derived Fuels,8504742,0,8504742
1992,CO,Coal,60495496,0,60495496
1992,CO,Hydroelectric Conventional,0,2998324,2998324
1992,CO,Natural Gas,2694376,0,2694376
1992,CO,Other Biomass,56346,0,56346
1992,CO,Petroleum,81776,0,81776
1992,CO,Pumped Storage,0,264662,264662
1992,CO,Total,0,66590980,66590980
1992,CT,Coal,7435992,0,7435992
1992,CT,Hydroelectric Conventional,0,847426,847426
1992,CT,Natural Gas,2943650,0,2943650
1992,CT,Nuclear,0,33541416,33541416
1992,CT,Other,0,0,0
1992,CT,Other Biomass,2674354,0,2674354
1992,CT,Other Gases,5638,0,5638
1992,CT,Petroleum,10967682,0,10967682
1992,CT,Pumped Storage,0,6602,6602
1992,CT,Total,0,58422760,58422760
1992,DC,Coal,0,0,0
1992,DC,Petroleum,147982,0,147982
1992,DC,Total,0,147982,147982
1992,DE,Coal,8007762,0,8007762
1992,DE,Natural Gas,1255950,0,1255950
1992,DE,Other,12630,0,12630
1992,DE,Other Gases,329762,0,329762
1992,DE,Petroleum,4362466,0,4362466
1992,DE,Total,0,13968570,13968570
1992,FL,Coal,125419306,0,125419306
1992,FL,Hydroelectric Conventional,0,471208,471208
1992,FL,Natural Gas,39839232,0,39839232
1992,FL,Nuclear,0,50231912,50231912
1992,FL,Other,3903716,0,3903716
1992,FL,Other Biomass,5841536,0,5841536
1992,FL,Other Gases,30356,0,30356
1992,FL,Petroleum,57235572,0,57235572
1992,FL,Total,0,287554286,287554286
1992,FL,Wood and Wood Derived Fuels,4581448,0,4581448
1992,GA,Coal,118455908,0,118455908
1992,GA,Hydroelectric Conventional,0,9830636,9830636
1992,GA,Natural Gas,1458580,0,1458580
1992,GA,Nuclear,0,55992596,55992596
1992,GA,Other Biomass,174128,0,174128
1992,GA,Petroleum,1626810,0,1626810
1992,GA,Pumped Storage,0,966158,966158
1992,GA,Total,0,194716458,194716458
1992,GA,Wood and Wood Derived Fuels,6211642,0,6211642
1992,HI,Coal,1113256,0,1113256
1992,HI,Geothermal,4268,0,4268
1992,HI,Hydroelectric Conventional,0,122246,122246
1992,HI,Other Biomass,1610084,0,1610084
1992,HI,Other Gases,124802,0,124802
1992,HI,Petroleum,16668406,0,16668406
1992,HI,Total,0,19688922,19688922
1992,HI,Wind,0,45352,45352
1992,HI,Wood and Wood Derived Fuels,508,0,508
1992,IA,Coal,51526026,0,51526026
1992,IA,Hydroelectric Conventional,0,1999330,1999330
1992,IA,Natural Gas,538022,0,538022
1992,IA,Nuclear,0,6810288,6810288
1992,IA,Other Biomass,40018,0,40018
1992,IA,Petroleum,80170,0,80170
1992,IA,Total,0,60993854,60993854
1992,ID,Coal,88742,0,88742
1992,ID,Hydroelectric Conventional,0,13307954,13307954
1992,ID,Natural Gas,275098,0,275098
1992,ID,Other,144064,0,144064
1992,ID,Other Biomass,17238,0,17238
1992,ID,Petroleum,4626,0,4626
1992,ID,Total,0,14926008,14926008
1992,ID,Wood and Wood Derived Fuels,1088286,0,1088286
1992,IL,Coal,102833182,0,102833182
1992,IL,Hydroelectric Conventional,0,278616,278616
1992,IL,Natural Gas,3407194,0,3407194
1992,IL,Nuclear,0,147484642,147484642
1992,IL,Other Biomass,404788,0,404788
1992,IL,Other Gases,808156,0,808156
1992,IL,Petroleum,875786,0,875786
1992,IL,Total,0,256092456,256092456
1992,IL,Wood and Wood Derived Fuels,92,0,92
1992,IN,Coal,193233760,0,193233760
1992,IN,Hydroelectric Conventional,0,1124952,1124952
1992,IN,Natural Gas,2368514,0,2368514
1992,IN,Other Biomass,66942,0,66942
1992,IN,Other Gases,4266832,0,4266832
1992,IN,Petroleum,976128,0,976128
1992,IN,Total,0,202037128,202037128
1992,KS,Coal,44305472,0,44305472
1992,KS,Hydroelectric Conventional,0,19536,19536
1992,KS,Natural Gas,2744784,0,2744784
1992,KS,Nuclear,0,16981316,16981316
1992,KS,Petroleum,105652,0,105652
1992,KS,Total,0,64156986,64156986
1992,KS,Wind,0,226,226
1992,KY,Coal,146952618,0,146952618
1992,KY,Hydroelectric Conventional,0,7534464,7534464
1992,KY,Natural Gas,47664,0,47664
1992,KY,Petroleum,167772,0,167772
1992,KY,Total,0,154702518,154702518
1992,LA,Coal,39680002,0,39680002
1992,LA,Hydroelectric Conventional,0,1312984,1312984
1992,LA,Natural Gas,73955596,0,73955596
1992,LA,Nuclear,0,20711040,20711040
1992,LA,Other,1404004,0,1404004
1992,LA,Other Biomass,160502,0,160502
1992,LA,Other Gases,2325632,0,2325632
1992,LA,Petroleum,2130928,0,2130928
1992,LA,Total,0,146748248,146748248
1992,LA,Wood and Wood Derived Fuels,5067560,0,5067560
1992,MA,Coal,22129394,0,22129394
1992,MA,Hydroelectric Conventional,0,2021712,2021712
1992,MA,Natural Gas,16958794,0,16958794
1992,MA,Nuclear,0,9483936,9483936
1992,MA,Other Biomass,3363780,0,3363780
1992,MA,Petroleum,27452632,0,27452632
1992,MA,Pumped Storage,0,-1297370,-1297370
1992,MA,Total,0,80175310,80175310
1992,MA,Wood and Wood Derived Fuels,62432,0,62432
1992,MD,Coal,47700940,0,47700940
1992,MD,Hydroelectric Conventional,0,3649318,3649318
1992,MD,Natural Gas,2155084,0,2155084
1992,MD,Nuclear,0,21327900,21327900
1992,MD,Other Biomass,659708,0,659708
1992,MD,Other Gases,1013144,0,1013144
1992,MD,Petroleum,5499022,0,5499022
1992,MD,Total,0,82354718,82354718
1992,MD,Wood and Wood Derived Fuels,349602,0,349602
1992,ME,Coal,1119688,0,1119688
1992,ME,Hydroelectric Conventional,0,7025212,7025212
1992,ME,Natural Gas,49374,0,49374
1992,ME,Nuclear,0,10715998,10715998
1992,ME,Other Biomass,818494,0,818494
1992,ME,Petroleum,4374164,0,4374164
1992,ME,Total,0,31367088,31367088
1992,ME,Wood and Wood Derived Fuels,7264158,0,7264158
1992,MI,Coal,126693404,0,126693404
1992,MI,Hydroelectric Conventional,0,3564542,3564542
1992,MI,Natural Gas,19057278,0,19057278
1992,MI,Nuclear,0,37697462,37697462
1992,MI,Other,62380,0,62380
1992,MI,Other Biomass,661004,0,661004
1992,MI,Other Gases,487508,0,487508
1992,MI,Petroleum,1257534,0,1257534
1992,MI,Pumped Storage,0,-1541804,-1541804
1992,MI,Total,0,190643878,190643878
1992,MI,Wood and Wood Derived Fuels,2704570,0,2704570
1992,MN,Coal,51402532,0,51402532
1992,MN,Hydroelectric Conventional,0,2125012,2125012
1992,MN,Natural Gas,1291776,0,1291776
1992,MN,Nuclear,0,22332710,22332710
1992,MN,Other Biomass,1050010,0,1050010
1992,MN,Petroleum,1297316,0,1297316
1992,MN,Total,0,80517768,80517768
1992,MN,Wind,0,290,290
1992,MN,Wood and Wood Derived Fuels,1018122,0,1018122
1992,MO,Coal,94198470,0,94198470
1992,MO,Hydroelectric Conventional,0,2962530,2962530
1992,MO,Natural Gas,475558,0,475558
1992,MO,Nuclear,0,16167950,16167950
1992,MO,Other Biomass,170,0,170
1992,MO,Petroleum,162156,0,162156
1992,MO,Pumped Storage,0,-63488,-63488
1992,MO,Total,0,113903346,113903346
1992,MS,Coal,15672180,0,15672180
1992,MS,Natural Gas,9470364,0,9470364
1992,MS,Nuclear,0,16347526,16347526
1992,MS,Petroleum,827806,0,827806
1992,MS,Total,0,46269926,46269926
1992,MS,Wood and Wood Derived Fuels,3952050,0,3952050
1992,MT,Coal,34907666,0,34907666
1992,MT,Hydroelectric Conventional,0,16541676,16541676
1992,MT,Natural Gas,69138,0,69138
1992,MT,Petroleum,33912,0,33912
1992,MT,Total,0,51799290,51799290
1992,MT,Wind,0,100,100
1992,MT,Wood and Wood Derived Fuels,246798,0,246798
1992,NC,Coal,116548038,0,116548038
1992,NC,Hydroelectric Conventional,0,11536906,11536906
1992,NC,Natural Gas,722616,0,722616
1992,NC,Nuclear,0,45507626,45507626
1992,NC,Other,450298,0,450298
1992,NC,Other Biomass,61012,0,61012
1992,NC,Petroleum,670092,0,670092
1992,NC,Pumped Storage,0,219770,219770
1992,NC,Total,0,179070510,179070510
1992,NC,Wood and Wood Derived Fuels,3354152,0,3354152
1992,ND,Coal,53921654,0,53921654
1992,ND,Hydroelectric Conventional,0,3397708,3397708
1992,ND,Natural Gas,26822,0,26822
1992,ND,Other Gases,77046,0,77046
1992,ND,Petroleum,110564,0,110564
1992,ND,Total,0,57533794,57533794
1992,NE,Coal,24880350,0,24880350
1992,NE,Hydroelectric Conventional,0,2150892,2150892
1992,NE,Natural Gas,290984,0,290984
1992,NE,Nuclear,0,17496936,17496936
1992,NE,Other Biomass,12870,0,12870
1992,NE,Petroleum,18964,0,18964
1992,NE,Total,0,44850996,44850996
1992,NH,Coal,6374174,0,6374174
1992,NH,Hydroelectric Conventional,0,2787262,2787262
1992,NH,Natural Gas,114002,0,114002
1992,NH,Nuclear,0,15737306,15737306
1992,NH,Other Biomass,328198,0,328198
1992,NH,Petroleum,2826548,0,2826548
1992,NH,Total,0,30234506,30234506
1992,NH,Wood and Wood Derived Fuels,2067016,0,2067016
1992,NJ,Coal,10818166,0,10818166
1992,NJ,Hydroelectric Conventional,0,44760,44760
1992,NJ,Natural Gas,29030062,0,29030062
1992,NJ,Nuclear,0,43190194,43190194
1992,NJ,Other Biomass,1808378,0,1808378
1992,NJ,Other Gases,96314,0,96314
1992,NJ,Petroleum,2616750,0,2616750
1992,NJ,Pumped Storage,0,-276596,-276596
1992,NJ,Total,0,87328028,87328028
1992,NM,Coal,50696826,0,50696826
1992,NM,Hydroelectric Conventional,0,510092,510092
1992,NM,Natural Gas,4829384,0,4829384
1992,NM,Other Biomass,28256,0,28256
1992,NM,Petroleum,74318,0,74318
1992,NM,Total,0,56138876,56138876
1992,NV,Coal,32886338,0,32886338
1992,NV,Geothermal,2355944,0,2355944
1992,NV,Hydroelectric Conventional,0,3971382,3971382
1992,NV,Natural Gas,6784394,0,6784394
1992,NV,Other,41858,0,41858
1992,NV,Petroleum,655170,0,655170
1992,NV,Total,0,46695086,46695086
1992,NY,Coal,54559406,0,54559406
1992,NY,Hydroelectric Conventional,0,56113294,56113294
1992,NY,Natural Gas,53699394,0,53699394
1992,NY,Nuclear,0,48309864,48309864
1992,NY,Other Biomass,3476970,0,3476970
1992,NY,Other Gases,183970,0,183970
1992,NY,Petroleum,36638516,0,36638516
1992,NY,Pumped Storage,0,-2063290,-2063290
1992,NY,Total,0,251897848,251897848
1992,NY,Wood and Wood Derived Fuels,979724,0,979724
1992,OH,Coal,242499892,0,242499892
1992,OH,Hydroelectric Conventional,0,506330,506330
1992,OH,Natural Gas,680472,0,680472
1992,OH,Nuclear,0,29610998,29610998
1992,OH,Other Biomass,698226,0,698226
1992,OH,Other Gases,147090,0,147090
1992,OH,Petroleum,516248,0,516248
1992,OH,Total,0,275323456,275323456
1992,OH,Wood and Wood Derived Fuels,664200,0,664200
1992,OK,Coal,60007692,0,60007692
1992,OK,Hydroelectric Conventional,0,6483402,6483402
1992,OK,Natural Gas,32838888,0,32838888
1992,OK,Other Biomass,3664,0,3664
1992,OK,Other Gases,144760,0,144760
1992,OK,Petroleum,103252,0,103252
1992,OK,Pumped Storage,0,-63728,-63728
1992,OK,Total,0,100012896,100012896
1992,OK,Wood and Wood Derived Fuels,494966,0,494966
1992,OR,Coal,7404162,0,7404162
1992,OR,Hydroelectric Conventional,0,63437070,63437070
1992,OR,Natural Gas,3055822,0,3055822
1992,OR,Nuclear,0,9145174,9145174
1992,OR,Other Biomass,187590,0,187590
1992,OR,Petroleum,21310,0,21310
1992,OR,Total,0,84690748,84690748
1992,OR,Wind,0,1078,1078
1992,OR,Wood and Wood Derived Fuels,1438542,0,1438542
1992,PA,Coal,218249394,0,218249394
1992,PA,Hydroelectric Conventional,0,5155230,5155230
1992,PA,Natural Gas,5415668,0,5415668
1992,PA,Nuclear,0,120265458,120265458
1992,PA,Other,487460,0,487460
1992,PA,Other Biomass,2504726,0,2504726
1992,PA,Other Gases,2022446,0,2022446
1992,PA,Petroleum,5296000,0,5296000
1992,PA,Pumped Storage,0,-1837778,-1837778
1992,PA,Total,0,358811290,358811290
1992,PA,Wood and Wood Derived Fuels,1252686,0,1252686
1992,RI,Coal,0,0,0
1992,RI,Hydroelectric Conventional,0,19892,19892
1992,RI,Natural Gas,9225012,0,9225012
1992,RI,Other Biomass,127668,0,127668
1992,RI,Petroleum,197838,0,197838
1992,RI,Total,0,9570410,9570410
1992,SC,Coal,47355730,0,47355730
1992,SC,Hydroelectric Conventional,0,6620892,6620892
1992,SC,Natural Gas,542358,0,542358
1992,SC,Nuclear,0,91073060,91073060
1992,SC,Other,12054,0,12054
1992,SC,Other Biomass,127624,0,127624
1992,SC,Other Gases,34718,0,34718
1992,SC,Petroleum,316374,0,316374
1992,SC,Pumped Storage,0,-1070994,-1070994
1992,SC,Total,0,148341018,148341018
1992,SC,Wood and Wood Derived Fuels,3329202,0,3329202
1992,SD,Coal,5252580,0,5252580
1992,SD,Hydroelectric Conventional,0,7224020,7224020
1992,SD,Natural Gas,1284,0,1284
1992,SD,Petroleum,14944,0,14944
1992,SD,Total,0,12492828,12492828
1992,TN,Coal,103055330,0,103055330
1992,TN,Hydroelectric Conventional,0,20022094,20022094
1992,TN,Natural Gas,551022,0,551022
1992,TN,Nuclear,0,31307160,31307160
1992,TN,Other,159074,0,159074
1992,TN,Other Biomass,109528,0,109528
1992,TN,Other Gases,6908,0,6908
1992,TN,Petroleum,259196,0,259196
1992,TN,Pumped Storage,0,-842766,-842766
1992,TN,Total,0,155496224,155496224
1992,TN,Wood and Wood Derived Fuels,868678,0,868678
1992,TX,Coal,242790324,0,242790324
1992,TX,Hydroelectric Conventional,0,5276328,5276328
1992,TX,Natural Gas,269278774,0,269278774
1992,TX,Nuclear,0,48992784,48992784
1992,TX,Other,649956,0,649956
1992,TX,Other Biomass,681304,0,681304
1992,TX,Other Gases,7054224,0,7054224
1992,TX,Petroleum,3256322,0,3256322
1992,TX,Solar Thermal and Photovoltaic,0,738,738
1992,TX,Total,0,580584626,580584626
1992,TX,Wood and Wood Derived Fuels,2603872,0,2603872
1992,UT,Coal,63105980,0,63105980
1992,UT,Geothermal,372738,0,372738
1992,UT,Hydroelectric Conventional,0,1204768,1204768
1992,UT,Natural Gas,1262870,0,1262870
1992,UT,Other Gases,460652,0,460652
1992,UT,Petroleum,67270,0,67270
1992,UT,Pumped Storage,0,0,0
1992,UT,Total,0,66474278,66474278
1992,VA,Coal,52450068,0,52450068
1992,VA,Hydroelectric Conventional,0,2179950,2179950
1992,VA,Natural Gas,4951380,0,4951380
1992,VA,Nuclear,0,46668680,46668680
1992,VA,Other,968,0,968
1992,VA,Other Biomass,1519828,0,1519828
1992,VA,Petroleum,3705730,0,3705730
1992,VA,Pumped Storage,0,-1329866,-1329866
1992,VA,Solar Thermal and Photovoltaic,0,22,22
1992,VA,Total,0,112704708,112704708
1992,VA,Wood and Wood Derived Fuels,2557948,0,2557948
1992,VT,Hydroelectric Conventional,0,1842996,1842996
1992,VT,Natural Gas,126240,0,126240
1992,VT,Nuclear,0,7469188,7469188
1992,VT,Petroleum,5376,0,5376
1992,VT,Total,0,9740284,9740284
1992,VT,Wind,0,0,0
1992,VT,Wood and Wood Derived Fuels,296484,0,296484
1992,WA,Coal,19316296,0,19316296
1992,WA,Hydroelectric Conventional,0,136649318,136649318
1992,WA,Natural Gas,2547526,0,2547526
1992,WA,Nuclear,0,11384758,11384758
1992,WA,Other,2,0,2
1992,WA,Other Biomass,345620,0,345620
1992,WA,Other Gases,468046,0,468046
1992,WA,Petroleum,51490,0,51490
1992,WA,Pumped Storage,0,0,0
1992,WA,Total,0,172964858,172964858
1992,WA,Wood and Wood Derived Fuels,2201802,0,2201802
1992,WI,Coal,67667886,0,67667886
1992,WI,Hydroelectric Conventional,0,4803210,4803210
1992,WI,Natural Gas,759182,0,759182
1992,WI,Nuclear,0,22414370,22414370
1992,WI,Other Biomass,324650,0,324650
1992,WI,Petroleum,310498,0,310498
1992,WI,Total,0,97786802,97786802
1992,WI,Wind,0,0,0
1992,WI,Wood and Wood Derived Fuels,1507006,0,1507006
1992,WV,Coal,146705104,0,146705104
1992,WV,Hydroelectric Conventional,0,2542126,2542126
1992,WV,Natural Gas,241712,0,241712
1992,WV,Other,100,0,100
1992,WV,Other Gases,348364,0,348364
1992,WV,Petroleum,482422,0,482422
1992,WV,Total,0,150319828,150319828
1992,WY,Coal,82761568,0,82761568
1992,WY,Hydroelectric Conventional,0,1271280,1271280
1992,WY,Natural Gas,682514,0,682514
1992,WY,Other,90792,0,90792
1992,WY,Other Gases,17284,0,17284
1992,WY,Petroleum,116966,0,116966
1992,WY,Total,0,84947788,84947788
1992,WY,Wood and Wood Derived Fuels,7384,0,7384
1993,AK,Coal,1066246,0,1066246
1993,AK,Hydroelectric Conventional,0,2605984,2605984
1993,AK,Natural Gas,6383628,0,6383628
1993,AK,Other Biomass,30844,0,30844
1993,AK,Petroleum,1174844,0,1174844
1993,AK,Total,0,11442554,11442554
1993,AK,Wind,0,0,0
1993,AK,Wood and Wood Derived Fuels,181008,0,181008
1993,AL,Coal,134672642,0,134672642
1993,AL,Hydroelectric Conventional,0,18068420,18068420
1993,AL,Natural Gas,2521956,0,2521956
1993,AL,Nuclear,0,35646650,35646650
1993,AL,Other Biomass,4766,0,4766
1993,AL,Other Gases,676210,0,676210
1993,AL,Petroleum,385888,0,385888
1993,AL,Total,0,198673992,198673992
1993,AL,Wood and Wood Derived Fuels,6697460,0,6697460
1993,AR,Coal,36183056,0,36183056
1993,AR,Hydroelectric Conventional,0,9018584,9018584
1993,AR,Natural Gas,5406522,0,5406522
1993,AR,Nuclear,0,27043352,27043352
1993,AR,Other Biomass,59214,0,59214
1993,AR,Petroleum,146254,0,146254
1993,AR,Pumped Storage,0,0,0
1993,AR,Total,0,80997308,80997308
1993,AR,Wood and Wood Derived Fuels,3140326,0,3140326
1993,AZ,Coal,74544390,0,74544390
1993,AZ,Hydroelectric Conventional,0,13394176,13394176
1993,AZ,Natural Gas,3873098,0,3873098
1993,AZ,Nuclear,0,44097760,44097760
1993,AZ,Petroleum,170884,0,170884
1993,AZ,Pumped Storage,0,651966,651966
1993,AZ,Total,0,136937972,136937972
1993,AZ,Wood and Wood Derived Fuels,205698,0,205698
1993,CA,Coal,6259902,0,6259902
1993,CA,Geothermal,29896226,0,29896226
1993,CA,Hydroelectric Conventional,0,80985052,80985052
1993,CA,Natural Gas,159288338,0,159288338
1993,CA,Nuclear,0,63161384,63161384
1993,CA,Other,22846,0,22846
1993,CA,Other Biomass,5782308,0,5782308
1993,CA,Other Gases,6194924,0,6194924
1993,CA,Petroleum,7203364,0,7203364
1993,CA,Pumped Storage,0,565848,565848
1993,CA,Solar Thermal and Photovoltaic,0,924156,924156
1993,CA,Total,0,373981284,373981284
1993,CA,Wind,0,5967280,5967280
1993,CA,Wood and Wood Derived Fuels,7729656,0,7729656
1993,CO,Coal,61402638,0,61402638
1993,CO,Hydroelectric Conventional,0,3823684,3823684
1993,CO,Natural Gas,3021726,0,3021726
1993,CO,Other Biomass,68896,0,68896
1993,CO,Petroleum,17932,0,17932
1993,CO,Pumped Storage,0,145490,145490
1993,CO,Total,0,68480366,68480366
1993,CT,Coal,7016634,0,7016634
1993,CT,Hydroelectric Conventional,0,829370,829370
1993,CT,Natural Gas,2767832,0,2767832
1993,CT,Nuclear,0,43603564,43603564
1993,CT,Other,0,0,0
1993,CT,Other Biomass,2791248,0,2791248
1993,CT,Petroleum,8769002,0,8769002
1993,CT,Pumped Storage,0,-8508,-8508
1993,CT,Total,0,65769142,65769142
1993,DC,Coal,0,0,0
1993,DC,Petroleum,376904,0,376904
1993,DC,Total,0,376904,376904
1993,DE,Coal,10749230,0,10749230
1993,DE,Natural Gas,2058380,0,2058380
1993,DE,Other,12098,0,12098
1993,DE,Other Gases,206412,0,206412
1993,DE,Petroleum,5009240,0,5009240
1993,DE,Total,0,18035360,18035360
1993,FL,Coal,126277348,0,126277348
1993,FL,Hydroelectric Conventional,0,421552,421552
1993,FL,Natural Gas,41509602,0,41509602
1993,FL,Nuclear,0,51773728,51773728
1993,FL,Other,3353910,0,3353910
1993,FL,Other Biomass,6193918,0,6193918
1993,FL,Other Gases,144826,0,144826
1993,FL,Petroleum,69454184,0,69454184
1993,FL,Total,0,303868312,303868312
1993,FL,Wood and Wood Derived Fuels,4739244,0,4739244
1993,GA,Coal,128505132,0,128505132
1993,GA,Hydroelectric Conventional,0,8913302,8913302
1993,GA,Natural Gas,1392428,0,1392428
1993,GA,Nuclear,0,54466704,54466704
1993,GA,Other Biomass,226788,0,226788
1993,GA,Petroleum,2275826,0,2275826
1993,GA,Pumped Storage,0,688888,688888
1993,GA,Total,0,202895142,202895142
1993,GA,Wood and Wood Derived Fuels,6426074,0,6426074
1993,HI,Coal,2958148,0,2958148
1993,HI,Geothermal,304498,0,304498
1993,HI,Hydroelectric Conventional,0,112486,112486
1993,HI,Other Biomass,1554112,0,1554112
1993,HI,Other Gases,126136,0,126136
1993,HI,Petroleum,14787962,0,14787962
1993,HI,Total,0,19887374,19887374
1993,HI,Wind,0,43888,43888
1993,HI,Wood and Wood Derived Fuels,144,0,144
1993,IA,Coal,55063288,0,55063288
1993,IA,Hydroelectric Conventional,0,1494364,1494364
1993,IA,Natural Gas,897978,0,897978
1993,IA,Nuclear,0,6470018,6470018
1993,IA,Other Biomass,58528,0,58528
1993,IA,Petroleum,113850,0,113850
1993,IA,Total,0,64098026,64098026
1993,IA,Wind,0,0,0
1993,ID,Coal,78598,0,78598
1993,ID,Hydroelectric Conventional,0,19430970,19430970
1993,ID,Natural Gas,313472,0,313472
1993,ID,Other,149688,0,149688
1993,ID,Other Biomass,20480,0,20480
1993,ID,Petroleum,864,0,864
1993,ID,Total,0,21066866,21066866
1993,ID,Wood and Wood Derived Fuels,1072794,0,1072794
1993,IL,Coal,122980630,0,122980630
1993,IL,Hydroelectric Conventional,0,260388,260388
1993,IL,Natural Gas,4253222,0,4253222
1993,IL,Nuclear,0,156746916,156746916
1993,IL,Other Biomass,502068,0,502068
1993,IL,Other Gases,694278,0,694278
1993,IL,Petroleum,1468184,0,1468184
1993,IL,Total,0,286906182,286906182
1993,IL,Wood and Wood Derived Fuels,496,0,496
1993,IN,Coal,199353906,0,199353906
1993,IN,Hydroelectric Conventional,0,896800,896800
1993,IN,Natural Gas,1949196,0,1949196
1993,IN,Other Biomass,64908,0,64908
1993,IN,Other Gases,4260918,0,4260918
1993,IN,Petroleum,744548,0,744548
1993,IN,Total,0,207270276,207270276
1993,KS,Coal,53599330,0,53599330
1993,KS,Hydroelectric Conventional,0,9970,9970
1993,KS,Natural Gas,3884908,0,3884908
1993,KS,Nuclear,0,15799086,15799086
1993,KS,Petroleum,191724,0,191724
1993,KS,Total,0,73485134,73485134
1993,KS,Wind,0,116,116
1993,KY,Coal,163444492,0,163444492
1993,KY,Hydroelectric Conventional,0,6310226,6310226
1993,KY,Natural Gas,47264,0,47264
1993,KY,Petroleum,193454,0,193454
1993,KY,Total,0,169995436,169995436
1993,LA,Coal,38823456,0,38823456
1993,LA,Hydroelectric Conventional,0,2463892,2463892
1993,LA,Natural Gas,72710450,0,72710450
1993,LA,Nuclear,0,28796206,28796206
1993,LA,Other,1432630,0,1432630
1993,LA,Other Biomass,168738,0,168738
1993,LA,Other Gases,1401174,0,1401174
1993,LA,Petroleum,6975132,0,6975132
1993,LA,Total,0,157951070,157951070
1993,LA,Wood and Wood Derived Fuels,5179392,0,5179392
1993,MA,Coal,19860788,0,19860788
1993,MA,Hydroelectric Conventional,0,1764746,1764746
1993,MA,Natural Gas,18100216,0,18100216
1993,MA,Nuclear,0,8677370,8677370
1993,MA,Other Biomass,3717996,0,3717996
1993,MA,Petroleum,23183704,0,23183704
1993,MA,Pumped Storage,0,-1357618,-1357618
1993,MA,Total,0,74158416,74158416
1993,MA,Wind,0,0,0
1993,MA,Wood and Wood Derived Fuels,211214,0,211214
1993,MD,Coal,50253958,0,50253958
1993,MD,Hydroelectric Conventional,0,3316542,3316542
1993,MD,Natural Gas,1544608,0,1544608
1993,MD,Nuclear,0,24601632,24601632
1993,MD,Other Biomass,607636,0,607636
1993,MD,Other Gases,951576,0,951576
1993,MD,Petroleum,8329580,0,8329580
1993,MD,Total,0,89955776,89955776
1993,MD,Wood and Wood Derived Fuels,350244,0,350244
1993,ME,Coal,1098340,0,1098340
1993,ME,Hydroelectric Conventional,0,6491560,6491560
1993,ME,Natural Gas,19756,0,19756
1993,ME,Nuclear,0,11479732,11479732
1993,ME,Other Biomass,978214,0,978214
1993,ME,Other Gases,9576,0,9576
1993,ME,Petroleum,3726182,0,3726182
1993,ME,Total,0,31228544,31228544
1993,ME,Wood and Wood Derived Fuels,7425184,0,7425184
1993,MI,Coal,127918160,0,127918160
1993,MI,Hydroelectric Conventional,0,3523684,3523684
1993,MI,Natural Gas,20040426,0,20040426
1993,MI,Nuclear,0,57050000,57050000
1993,MI,Other,74222,0,74222
1993,MI,Other Biomass,974808,0,974808
1993,MI,Other Gases,6742,0,6742
1993,MI,Petroleum,1523150,0,1523150
1993,MI,Pumped Storage,0,-1546428,-1546428
1993,MI,Total,0,212737098,212737098
1993,MI,Wood and Wood Derived Fuels,3172334,0,3172334
1993,MN,Coal,57304724,0,57304724
1993,MN,Hydroelectric Conventional,0,2301616,2301616
1993,MN,Natural Gas,1025386,0,1025386
1993,MN,Nuclear,0,23972106,23972106
1993,MN,Other Biomass,1053950,0,1053950
1993,MN,Petroleum,1275808,0,1275808
1993,MN,Total,0,88081270,88081270
1993,MN,Wind,0,370,370
1993,MN,Wood and Wood Derived Fuels,1147310,0,1147310
1993,MO,Coal,81967920,0,81967920
1993,MO,Hydroelectric Conventional,0,6368966,6368966
1993,MO,Natural Gas,879948,0,879948
1993,MO,Nuclear,0,16762666,16762666
1993,MO,Other Biomass,4496,0,4496
1993,MO,Petroleum,1270556,0,1270556
1993,MO,Pumped Storage,0,-148614,-148614
1993,MO,Total,0,107105938,107105938
1993,MS,Coal,17760428,0,17760428
1993,MS,Natural Gas,7209294,0,7209294
1993,MS,Nuclear,0,15807094,15807094
1993,MS,Petroleum,7201080,0,7201080
1993,MS,Total,0,51883052,51883052
1993,MS,Wood and Wood Derived Fuels,3905156,0,3905156
1993,MT,Coal,28165716,0,28165716
1993,MT,Hydroelectric Conventional,0,19228176,19228176
1993,MT,Natural Gas,69840,0,69840
1993,MT,Petroleum,44138,0,44138
1993,MT,Total,0,47745708,47745708
1993,MT,Wood and Wood Derived Fuels,237838,0,237838
1993,NC,Coal,127145308,0,127145308
1993,NC,Hydroelectric Conventional,0,9974140,9974140
1993,NC,Natural Gas,789500,0,789500
1993,NC,Nuclear,0,47517854,47517854
1993,NC,Other,469964,0,469964
1993,NC,Other Biomass,85010,0,85010
1993,NC,Petroleum,814510,0,814510
1993,NC,Pumped Storage,0,492604,492604
1993,NC,Total,0,190628888,190628888
1993,NC,Wood and Wood Derived Fuels,3339998,0,3339998
1993,ND,Coal,54281426,0,54281426
1993,ND,Hydroelectric Conventional,0,2830220,2830220
1993,ND,Natural Gas,14152,0,14152
1993,ND,Other Gases,78786,0,78786
1993,ND,Petroleum,122236,0,122236
1993,ND,Total,0,57326820,57326820
1993,NE,Coal,29552422,0,29552422
1993,NE,Hydroelectric Conventional,0,2003326,2003326
1993,NE,Natural Gas,306130,0,306130
1993,NE,Nuclear,0,13610266,13610266
1993,NE,Other Biomass,11500,0,11500
1993,NE,Petroleum,38070,0,38070
1993,NE,Total,0,45521714,45521714
1993,NH,Coal,6526482,0,6526482
1993,NH,Hydroelectric Conventional,0,2821218,2821218
1993,NH,Natural Gas,23006,0,23006
1993,NH,Nuclear,0,18093610,18093610
1993,NH,Other Biomass,335742,0,335742
1993,NH,Petroleum,2609146,0,2609146
1993,NH,Total,0,32485520,32485520
1993,NH,Wood and Wood Derived Fuels,2076316,0,2076316
1993,NJ,Coal,10931542,0,10931542
1993,NJ,Hydroelectric Conventional,0,38010,38010
1993,NJ,Natural Gas,31090078,0,31090078
1993,NJ,Nuclear,0,49864480,49864480
1993,NJ,Other Biomass,1887954,0,1887954
1993,NJ,Other Gases,173720,0,173720
1993,NJ,Petroleum,2950448,0,2950448
1993,NJ,Pumped Storage,0,-246468,-246468
1993,NJ,Total,0,96689764,96689764
1993,NM,Coal,51014058,0,51014058
1993,NM,Hydroelectric Conventional,0,587654,587654
1993,NM,Natural Gas,5777132,0,5777132
1993,NM,Other Biomass,23632,0,23632
1993,NM,Petroleum,86580,0,86580
1993,NM,Total,0,57489056,57489056
1993,NV,Coal,31255720,0,31255720
1993,NV,Geothermal,3080110,0,3080110
1993,NV,Hydroelectric Conventional,0,3944360,3944360
1993,NV,Natural Gas,8066396,0,8066396
1993,NV,Other,4396,0,4396
1993,NV,Petroleum,653962,0,653962
1993,NV,Total,0,47004944,47004944
1993,NY,Coal,49003932,0,49003932
1993,NY,Hydroelectric Conventional,0,58886592,58886592
1993,NY,Natural Gas,54150534,0,54150534
1993,NY,Nuclear,0,53778522,53778522
1993,NY,Other Biomass,3449926,0,3449926
1993,NY,Other Gases,181960,0,181960
1993,NY,Petroleum,30145930,0,30145930
1993,NY,Pumped Storage,0,-2271404,-2271404
1993,NY,Total,0,248442062,248442062
1993,NY,Wood and Wood Derived Fuels,1116070,0,1116070
1993,OH,Coal,247591824,0,247591824
1993,OH,Hydroelectric Conventional,0,379226,379226
1993,OH,Natural Gas,742904,0,742904
1993,OH,Nuclear,0,20021322,20021322
1993,OH,Other Biomass,198090,0,198090
1993,OH,Other Gases,257040,0,257040
1993,OH,Petroleum,692004,0,692004
1993,OH,Total,0,270474584,270474584
1993,OH,Wood and Wood Derived Fuels,592174,0,592174
1993,OK,Coal,63384350,0,63384350
1993,OK,Hydroelectric Conventional,0,8714912,8714912
1993,OK,Natural Gas,33525134,0,33525134
1993,OK,Other Biomass,0,0,0
1993,OK,Other Gases,179312,0,179312
1993,OK,Petroleum,112638,0,112638
1993,OK,Pumped Storage,0,-122088,-122088
1993,OK,Total,0,106319346,106319346
1993,OK,Wood and Wood Derived Fuels,525088,0,525088
1993,OR,Coal,7040784,0,7040784
1993,OR,Hydroelectric Conventional,0,71728160,71728160
1993,OR,Natural Gas,3556134,0,3556134
1993,OR,Nuclear,0,-42552,-42552
1993,OR,Other Biomass,190476,0,190476
1993,OR,Petroleum,67336,0,67336
1993,OR,Total,0,83819170,83819170
1993,OR,Wood and Wood Derived Fuels,1278832,0,1278832
1993,PA,Coal,216263636,0,216263636
1993,PA,Hydroelectric Conventional,0,4752932,4752932
1993,PA,Natural Gas,7739338,0,7739338
1993,PA,Nuclear,0,118661068,118661068
1993,PA,Other,415020,0,415020
1993,PA,Other Biomass,2851962,0,2851962
1993,PA,Other Gases,2195950,0,2195950
1993,PA,Petroleum,10026640,0,10026640
1993,PA,Pumped Storage,0,-1768094,-1768094
1993,PA,Total,0,362428264,362428264
1993,PA,Wood and Wood Derived Fuels,1289812,0,1289812
1993,RI,Coal,0,0,0
1993,RI,Hydroelectric Conventional,0,18770,18770
1993,RI,Natural Gas,9017264,0,9017264
1993,RI,Other Biomass,149596,0,149596
1993,RI,Petroleum,144962,0,144962
1993,RI,Total,0,9330592,9330592
1993,SC,Coal,54479918,0,54479918
1993,SC,Hydroelectric Conventional,0,5900278,5900278
1993,SC,Natural Gas,415432,0,415432
1993,SC,Nuclear,0,92377768,92377768
1993,SC,Other,15034,0,15034
1993,SC,Other Biomass,124250,0,124250
1993,SC,Other Gases,48822,0,48822
1993,SC,Petroleum,404478,0,404478
1993,SC,Pumped Storage,0,-478232,-478232
1993,SC,Total,0,156349670,156349670
1993,SC,Wood and Wood Derived Fuels,3061922,0,3061922
1993,SD,Coal,5283164,0,5283164
1993,SD,Hydroelectric Conventional,0,5182230,5182230
1993,SD,Natural Gas,21054,0,21054
1993,SD,Petroleum,24574,0,24574
1993,SD,Total,0,10511022,10511022
1993,TN,Coal,122189644,0,122189644
1993,TN,Hydroelectric Conventional,0,17908454,17908454
1993,TN,Natural Gas,585454,0,585454
1993,TN,Nuclear,0,6609672,6609672
1993,TN,Other,136472,0,136472
1993,TN,Other Biomass,123318,0,123318
1993,TN,Other Gases,5362,0,5362
1993,TN,Petroleum,478212,0,478212
1993,TN,Pumped Storage,0,-1120316,-1120316
1993,TN,Total,0,147768398,147768398
1993,TN,Wood and Wood Derived Fuels,852126,0,852126
1993,TX,Coal,262092004,0,262092004
1993,TX,Hydroelectric Conventional,0,3572810,3572810
1993,TX,Natural Gas,294588228,0,294588228
1993,TX,Nuclear,0,24813548,24813548
1993,TX,Other,802260,0,802260
1993,TX,Other Biomass,736464,0,736464
1993,TX,Other Gases,6562740,0,6562740
1993,TX,Petroleum,3708936,0,3708936
1993,TX,Solar Thermal and Photovoltaic,0,732,732
1993,TX,Total,0,599377430,599377430
1993,TX,Wood and Wood Derived Fuels,2499708,0,2499708
1993,UT,Coal,64251586,0,64251586
1993,UT,Geothermal,296296,0,296296
1993,UT,Hydroelectric Conventional,0,1720038,1720038
1993,UT,Natural Gas,1212198,0,1212198
1993,UT,Other Gases,562914,0,562914
1993,UT,Petroleum,73172,0,73172
1993,UT,Pumped Storage,0,0,0
1993,UT,Total,0,68116204,68116204
1993,VA,Coal,58820002,0,58820002
1993,VA,Hydroelectric Conventional,0,2626606,2626606
1993,VA,Natural Gas,8756132,0,8756132
1993,VA,Nuclear,0,45377526,45377526
1993,VA,Other Biomass,863066,0,863066
1993,VA,Petroleum,5001618,0,5001618
1993,VA,Pumped Storage,0,-1548170,-1548170
1993,VA,Solar Thermal and Photovoltaic,0,16,16
1993,VA,Total,0,122487020,122487020
1993,VA,Wood and Wood Derived Fuels,2590224,0,2590224
1993,VT,Hydroelectric Conventional,0,1962572,1962572
1993,VT,Natural Gas,41116,0,41116
1993,VT,Nuclear,0,6744296,6744296
1993,VT,Petroleum,10058,0,10058
1993,VT,Total,0,9287530,9287530
1993,VT,Wind,0,0,0
1993,VT,Wood and Wood Derived Fuels,529488,0,529488
1993,WA,Coal,17670158,0,17670158
1993,WA,Hydroelectric Conventional,0,134624766,134624766
1993,WA,Natural Gas,6395890,0,6395890
1993,WA,Nuclear,0,14269932,14269932
1993,WA,Other,14,0,14
1993,WA,Other Biomass,429980,0,429980
1993,WA,Other Gases,445704,0,445704
1993,WA,Petroleum,118868,0,118868
1993,WA,Pumped Storage,0,0,0
1993,WA,Total,0,175991552,175991552
1993,WA,Wood and Wood Derived Fuels,2036240,0,2036240
1993,WI,Coal,69101890,0,69101890
1993,WI,Hydroelectric Conventional,0,4973174,4973174
1993,WI,Natural Gas,823352,0,823352
1993,WI,Nuclear,0,22929148,22929148
1993,WI,Other Biomass,341174,0,341174
1993,WI,Petroleum,671112,0,671112
1993,WI,Total,0,100477104,100477104
1993,WI,Wind,0,0,0
1993,WI,Wood and Wood Derived Fuels,1637254,0,1637254
1993,WV,Coal,145937330,0,145937330
1993,WV,Hydroelectric Conventional,0,2228202,2228202
1993,WV,Natural Gas,316484,0,316484
1993,WV,Other,72,0,72
1993,WV,Other Gases,542372,0,542372
1993,WV,Petroleum,473868,0,473868
1993,WV,Total,0,149498328,149498328
1993,WY,Coal,79014184,0,79014184
1993,WY,Hydroelectric Conventional,0,1574854,1574854
1993,WY,Natural Gas,731080,0,731080
1993,WY,Other,85686,0,85686
1993,WY,Other Gases,4142,0,4142
1993,WY,Petroleum,132762,0,132762
1993,WY,Total,0,81542708,81542708
1993,WY,Wood and Wood Derived Fuels,0,0,0
1994,AK,Coal,1005732,0,1005732
1994,AK,Hydroelectric Conventional,0,2690814,2690814
1994,AK,Natural Gas,6802350,0,6802350
1994,AK,Other Biomass,32564,0,32564
1994,AK,Petroleum,1125288,0,1125288
1994,AK,Total,0,11933032,11933032
1994,AK,Wind,0,0,0
1994,AK,Wood and Wood Derived Fuels,276284,0,276284
1994,AL,Coal,126608150,0,126608150
1994,AL,Hydroelectric Conventional,0,22858240,22858240
1994,AL,Natural Gas,2496068,0,2496068
1994,AL,Nuclear,0,40959518,40959518
1994,AL,Other Biomass,13600,0,13600
1994,AL,Other Gases,656766,0,656766
1994,AL,Petroleum,489968,0,489968
1994,AL,Total,0,201528514,201528514
1994,AL,Wood and Wood Derived Fuels,7446204,0,7446204
1994,AR,Coal,39704236,0,39704236
1994,AR,Hydroelectric Conventional,0,6925282,6925282
1994,AR,Natural Gas,6250654,0,6250654
1994,AR,Nuclear,0,27847402,27847402
1994,AR,Other,3674,0,3674
1994,AR,Other Biomass,68704,0,68704
1994,AR,Petroleum,199226,0,199226
1994,AR,Pumped Storage,0,0,0
1994,AR,Total,0,84064296,84064296
1994,AR,Wood and Wood Derived Fuels,3065118,0,3065118
1994,AZ,Coal,76686260,0,76686260
1994,AZ,Hydroelectric Conventional,0,14730850,14730850
1994,AZ,Natural Gas,4967070,0,4967070
1994,AZ,Nuclear,0,46341788,46341788
1994,AZ,Petroleum,304340,0,304340
1994,AZ,Pumped Storage,0,608874,608874
1994,AZ,Total,0,143868992,143868992
1994,AZ,Wood and Wood Derived Fuels,229810,0,229810
1994,CA,Coal,6543382,0,6543382
1994,CA,Geothermal,27320804,0,27320804
1994,CA,Hydroelectric Conventional,0,46025230,46025230
1994,CA,Natural Gas,188863600,0,188863600
1994,CA,Nuclear,0,67504474,67504474
1994,CA,Other,28250,0,28250
1994,CA,Other Biomass,5293680,0,5293680
1994,CA,Other Gases,5918628,0,5918628
1994,CA,Petroleum,6822282,0,6822282
1994,CA,Pumped Storage,0,1869698,1869698
1994,CA,Solar Thermal and Photovoltaic,0,972636,972636
1994,CA,Total,0,372383982,372383982
1994,CA,Wind,0,6774256,6774256
1994,CA,Wood and Wood Derived Fuels,8447062,0,8447062
1994,CO,Coal,63273166,0,63273166
1994,CO,Hydroelectric Conventional,0,3088074,3088074
1994,CO,Natural Gas,4641484,0,4641484
1994,CO,Other Biomass,56924,0,56924
1994,CO,Petroleum,20440,0,20440
1994,CO,Pumped Storage,0,223734,223734
1994,CO,Total,0,71303822,71303822
1994,CT,Coal,7245552,0,7245552
1994,CT,Hydroelectric Conventional,0,962324,962324
1994,CT,Natural Gas,3797170,0,3797170
1994,CT,Nuclear,0,40319876,40319876
1994,CT,Other,0,0,0
1994,CT,Other Biomass,2940198,0,2940198
1994,CT,Petroleum,7087124,0,7087124
1994,CT,Pumped Storage,0,5590,5590
1994,CT,Total,0,62357834,62357834
1994,DC,Coal,0,0,0
1994,DC,Petroleum,548504,0,548504
1994,DC,Total,0,548504,548504
1994,DE,Coal,9898806,0,9898806
1994,DE,Natural Gas,4260834,0,4260834
1994,DE,Other,15940,0,15940
1994,DE,Other Gases,201770,0,201770
1994,DE,Petroleum,4083202,0,4083202
1994,DE,Total,0,18460552,18460552
1994,FL,Coal,126930216,0,126930216
1994,FL,Hydroelectric Conventional,0,548948,548948
1994,FL,Natural Gas,52303858,0,52303858
1994,FL,Nuclear,0,53364214,53364214
1994,FL,Other,4102684,0,4102684
1994,FL,Other Biomass,6354374,0,6354374
1994,FL,Other Gases,69758,0,69758
1994,FL,Petroleum,67794768,0,67794768
1994,FL,Total,0,316293692,316293692
1994,FL,Wood and Wood Derived Fuels,4824872,0,4824872
1994,GA,Coal,131397504,0,131397504
1994,GA,Hydroelectric Conventional,0,8662870,8662870
1994,GA,Natural Gas,1267902,0,1267902
1994,GA,Nuclear,0,57854180,57854180
1994,GA,Other Biomass,117142,0,117142
1994,GA,Petroleum,1996558,0,1996558
1994,GA,Pumped Storage,0,1156912,1156912
1994,GA,Total,0,208712818,208712818
1994,GA,Wood and Wood Derived Fuels,6259750,0,6259750
1994,HI,Coal,2653484,0,2653484
1994,HI,Geothermal,370636,0,370636
1994,HI,Hydroelectric Conventional,0,278852,278852
1994,HI,Other Biomass,1460248,0,1460248
1994,HI,Other Gases,131438,0,131438
1994,HI,Petroleum,15281826,0,15281826
1994,HI,Total,0,20217804,20217804
1994,HI,Wind,0,40700,40700
1994,HI,Wood and Wood Derived Fuels,620,0,620
1994,IA,Coal,54901784,0,54901784
1994,IA,Hydroelectric Conventional,0,2142046,2142046
1994,IA,Natural Gas,752970,0,752970
1994,IA,Nuclear,0,8214766,8214766
1994,IA,Other Biomass,118570,0,118570
1994,IA,Petroleum,203580,0,203580
1994,IA,Total,0,66334012,66334012
1994,IA,Wind,0,106,106
1994,IA,Wood and Wood Derived Fuels,190,0,190
1994,ID,Coal,76076,0,76076
1994,ID,Hydroelectric Conventional,0,15832306,15832306
1994,ID,Natural Gas,318122,0,318122
1994,ID,Other,170276,0,170276
1994,ID,Other Biomass,24420,0,24420
1994,ID,Petroleum,130,0,130
1994,ID,Total,0,17453594,17453594
1994,ID,Wood and Wood Derived Fuels,1032264,0,1032264
1994,IL,Coal,125996826,0,125996826
1994,IL,Hydroelectric Conventional,0,241266,241266
1994,IL,Natural Gas,7466108,0,7466108
1994,IL,Nuclear,0,145308998,145308998
1994,IL,Other Biomass,579838,0,579838
1994,IL,Other Gases,518348,0,518348
1994,IL,Petroleum,2486912,0,2486912
1994,IL,Total,0,282598590,282598590
1994,IL,Wood and Wood Derived Fuels,294,0,294
1994,IN,Coal,205842852,0,205842852
1994,IN,Hydroelectric Conventional,0,813734,813734
1994,IN,Natural Gas,3018342,0,3018342
1994,IN,Other Biomass,73986,0,73986
1994,IN,Other Gases,3883036,0,3883036
1994,IN,Petroleum,732164,0,732164
1994,IN,Total,0,214364114,214364114
1994,KS,Coal,52977510,0,52977510
1994,KS,Hydroelectric Conventional,0,19708,19708
1994,KS,Natural Gas,5007210,0,5007210
1994,KS,Nuclear,0,17058004,17058004
1994,KS,Petroleum,177196,0,177196
1994,KS,Total,0,75239738,75239738
1994,KS,Wind,0,110,110
1994,KY,Coal,159794884,0,159794884
1994,KY,Hydroelectric Conventional,0,8027180,8027180
1994,KY,Natural Gas,62366,0,62366
1994,KY,Petroleum,309638,0,309638
1994,KY,Total,0,168194068,168194068
1994,LA,Coal,40326824,0,40326824
1994,LA,Hydroelectric Conventional,0,1943956,1943956
1994,LA,Natural Gas,77023170,0,77023170
1994,LA,Nuclear,0,25557270,25557270
1994,LA,Other,1355132,0,1355132
1994,LA,Other Biomass,185726,0,185726
1994,LA,Other Gases,2670248,0,2670248
1994,LA,Petroleum,4640786,0,4640786
1994,LA,Total,0,158771922,158771922
1994,LA,Wood and Wood Derived Fuels,5068810,0,5068810
1994,MA,Coal,20640294,0,20640294
1994,MA,Hydroelectric Conventional,0,1875834,1875834
1994,MA,Natural Gas,22639352,0,22639352
1994,MA,Nuclear,0,7717138,7717138
1994,MA,Other Biomass,3867774,0,3867774
1994,MA,Petroleum,20197282,0,20197282
1994,MA,Pumped Storage,0,-1292192,-1292192
1994,MA,Total,0,75878128,75878128
1994,MA,Wind,0,0,0
1994,MA,Wood and Wood Derived Fuels,232646,0,232646
1994,MD,Coal,51249516,0,51249516
1994,MD,Hydroelectric Conventional,0,4019072,4019072
1994,MD,Natural Gas,2344084,0,2344084
1994,MD,Nuclear,0,22470816,22470816
1994,MD,Other Biomass,704128,0,704128
1994,MD,Other Gases,1003524,0,1003524
1994,MD,Petroleum,8550452,0,8550452
1994,MD,Total,0,90679236,90679236
1994,MD,Wood and Wood Derived Fuels,337644,0,337644
1994,ME,Coal,1353840,0,1353840
1994,ME,Hydroelectric Conventional,0,7021534,7021534
1994,ME,Natural Gas,18534,0,18534
1994,ME,Nuclear,0,13263968,13263968
1994,ME,Other Biomass,1024996,0,1024996
1994,ME,Other Gases,7856,0,7856
1994,ME,Petroleum,3744676,0,3744676
1994,ME,Total,0,32912300,32912300
1994,ME,Wood and Wood Derived Fuels,6476896,0,6476896
1994,MI,Coal,139543232,0,139543232
1994,MI,Hydroelectric Conventional,0,3320536,3320536
1994,MI,Natural Gas,20873098,0,20873098
1994,MI,Nuclear,0,28288562,28288562
1994,MI,Other,30614,0,30614
1994,MI,Other Biomass,1086404,0,1086404
1994,MI,Other Gases,9268,0,9268
1994,MI,Petroleum,1651046,0,1651046
1994,MI,Pumped Storage,0,-1622126,-1622126
1994,MI,Total,0,196614778,196614778
1994,MI,Wood and Wood Derived Fuels,3434144,0,3434144
1994,MN,Coal,56251406,0,56251406
1994,MN,Hydroelectric Conventional,0,2277466,2277466
1994,MN,Natural Gas,1313714,0,1313714
1994,MN,Nuclear,0,24447240,24447240
1994,MN,Other Biomass,1241734,0,1241734
1994,MN,Petroleum,1215400,0,1215400
1994,MN,Total,0,87795310,87795310
1994,MN,Wind,0,79046,79046
1994,MN,Wood and Wood Derived Fuels,969304,0,969304
1994,MO,Coal,97771238,0,97771238
1994,MO,Hydroelectric Conventional,0,3832586,3832586
1994,MO,Natural Gas,778604,0,778604
1994,MO,Nuclear,0,20012982,20012982
1994,MO,Other Biomass,13830,0,13830
1994,MO,Petroleum,1490430,0,1490430
1994,MO,Pumped Storage,0,-144314,-144314
1994,MO,Total,0,123755356,123755356
1994,MS,Coal,17893948,0,17893948
1994,MS,Natural Gas,14446768,0,14446768
1994,MS,Nuclear,0,19229398,19229398
1994,MS,Petroleum,2248310,0,2248310
1994,MS,Total,0,57340996,57340996
1994,MS,Wood and Wood Derived Fuels,3522572,0,3522572
1994,MT,Coal,33618778,0,33618778
1994,MT,Hydroelectric Conventional,0,16299014,16299014
1994,MT,Natural Gas,146452,0,146452
1994,MT,Petroleum,40244,0,40244
1994,MT,Total,0,50305698,50305698
1994,MT,Wood and Wood Derived Fuels,201210,0,201210
1994,NC,Coal,116248780,0,116248780
1994,NC,Hydroelectric Conventional,0,14384552,14384552
1994,NC,Natural Gas,620484,0,620484
1994,NC,Nuclear,0,64692014,64692014
1994,NC,Other,521554,0,521554
1994,NC,Other Biomass,90050,0,90050
1994,NC,Petroleum,904468,0,904468
1994,NC,Pumped Storage,0,761638,761638
1994,NC,Total,0,201657324,201657324
1994,NC,Wood and Wood Derived Fuels,3433784,0,3433784
1994,ND,Coal,54362174,0,54362174
1994,ND,Hydroelectric Conventional,0,3712922,3712922
1994,ND,Natural Gas,110,0,110
1994,ND,Other Biomass,27166,0,27166
1994,ND,Other Gases,87558,0,87558
1994,ND,Petroleum,121720,0,121720
1994,ND,Total,0,58311650,58311650
1994,NE,Coal,28078934,0,28078934
1994,NE,Hydroelectric Conventional,0,2623766,2623766
1994,NE,Natural Gas,517836,0,517836
1994,NE,Nuclear,0,12690660,12690660
1994,NE,Other Biomass,18664,0,18664
1994,NE,Petroleum,36402,0,36402
1994,NE,Total,0,43966262,43966262
1994,NH,Coal,6363308,0,6363308
1994,NH,Hydroelectric Conventional,0,2922654,2922654
1994,NH,Natural Gas,229174,0,229174
1994,NH,Nuclear,0,12407494,12407494
1994,NH,Other Biomass,307688,0,307688
1994,NH,Petroleum,2841156,0,2841156
1994,NH,Total,0,26924998,26924998
1994,NH,Wood and Wood Derived Fuels,1853524,0,1853524
1994,NJ,Coal,11344422,0,11344422
1994,NJ,Hydroelectric Conventional,0,30166,30166
1994,NJ,Natural Gas,34383656,0,34383656
1994,NJ,Nuclear,0,44258670,44258670
1994,NJ,Other Biomass,2270764,0,2270764
1994,NJ,Other Gases,203018,0,203018
1994,NJ,Petroleum,4713456,0,4713456
1994,NJ,Pumped Storage,0,-333468,-333468
1994,NJ,Total,0,96870684,96870684
1994,NM,Coal,53504698,0,53504698
1994,NM,Hydroelectric Conventional,0,425780,425780
1994,NM,Natural Gas,6777874,0,6777874
1994,NM,Other Biomass,21604,0,21604
1994,NM,Petroleum,51392,0,51392
1994,NM,Total,0,60781348,60781348
1994,NV,Coal,30649428,0,30649428
1994,NV,Geothermal,2989860,0,2989860
1994,NV,Hydroelectric Conventional,0,3751778,3751778
1994,NV,Natural Gas,11259252,0,11259252
1994,NV,Other,49776,0,49776
1994,NV,Petroleum,335360,0,335360
1994,NV,Total,0,49035454,49035454
1994,NY,Coal,46581312,0,46581312
1994,NY,Hydroelectric Conventional,0,55582514,55582514
1994,NY,Natural Gas,64459858,0,64459858
1994,NY,Nuclear,0,58462868,58462868
1994,NY,Other Biomass,3808136,0,3808136
1994,NY,Other Gases,188412,0,188412
1994,NY,Petroleum,24060756,0,24060756
1994,NY,Pumped Storage,0,-2291688,-2291688
1994,NY,Total,0,252059144,252059144
1994,NY,Wood and Wood Derived Fuels,1206976,0,1206976
1994,OH,Coal,238339116,0,238339116
1994,OH,Hydroelectric Conventional,0,383542,383542
1994,OH,Natural Gas,743182,0,743182
1994,OH,Nuclear,0,21904494,21904494
1994,OH,Other Biomass,57660,0,57660
1994,OH,Other Gases,288600,0,288600
1994,OH,Petroleum,848976,0,848976
1994,OH,Total,0,263527220,263527220
1994,OH,Wood and Wood Derived Fuels,961650,0,961650
1994,OK,Coal,61001694,0,61001694
1994,OK,Hydroelectric Conventional,0,5029296,5029296
1994,OK,Natural Gas,33417764,0,33417764
1994,OK,Other Biomass,0,0,0
1994,OK,Other Gases,140792,0,140792
1994,OK,Petroleum,85242,0,85242
1994,OK,Pumped Storage,0,-100026,-100026
1994,OK,Total,0,100117544,100117544
1994,OK,Wood and Wood Derived Fuels,542782,0,542782
1994,OR,Coal,7666940,0,7666940
1994,OR,Hydroelectric Conventional,0,62440596,62440596
1994,OR,Natural Gas,5671768,0,5671768
1994,OR,Other Biomass,191860,0,191860
1994,OR,Petroleum,14592,0,14592
1994,OR,Total,0,76881624,76881624
1994,OR,Wood and Wood Derived Fuels,895868,0,895868
1994,PA,Coal,203735180,0,203735180
1994,PA,Hydroelectric Conventional,0,5499570,5499570
1994,PA,Natural Gas,8159528,0,8159528
1994,PA,Nuclear,0,134413630,134413630
1994,PA,Other,165446,0,165446
1994,PA,Other Biomass,2856196,0,2856196
1994,PA,Other Gases,1944326,0,1944326
1994,PA,Petroleum,11648618,0,11648618
1994,PA,Pumped Storage,0,-1686138,-1686138
1994,PA,Total,0,368157402,368157402
1994,PA,Wood and Wood Derived Fuels,1421046,0,1421046
1994,RI,Coal,0,0,0
1994,RI,Hydroelectric Conventional,0,18698,18698
1994,RI,Natural Gas,9121358,0,9121358
1994,RI,Other Biomass,151366,0,151366
1994,RI,Other Gases,3724,0,3724
1994,RI,Petroleum,170694,0,170694
1994,RI,Total,0,9465840,9465840
1994,SC,Coal,55482230,0,55482230
1994,SC,Hydroelectric Conventional,0,6069904,6069904
1994,SC,Natural Gas,727400,0,727400
1994,SC,Nuclear,0,88932352,88932352
1994,SC,Other,9588,0,9588
1994,SC,Other Biomass,110862,0,110862
1994,SC,Other Gases,34736,0,34736
1994,SC,Petroleum,481488,0,481488
1994,SC,Pumped Storage,0,-1241712,-1241712
1994,SC,Total,0,153885044,153885044
1994,SC,Wood and Wood Derived Fuels,3278196,0,3278196
1994,SD,Coal,5666664,0,5666664
1994,SD,Hydroelectric Conventional,0,10257520,10257520
1994,SD,Natural Gas,16874,0,16874
1994,SD,Petroleum,41462,0,41462
1994,SD,Total,0,15982520,15982520
1994,TN,Coal,107417096,0,107417096
1994,TN,Hydroelectric Conventional,0,24055918,24055918
1994,TN,Natural Gas,608556,0,608556
1994,TN,Nuclear,0,23864704,23864704
1994,TN,Other,223352,0,223352
1994,TN,Other Biomass,132916,0,132916
1994,TN,Other Gases,6060,0,6060
1994,TN,Petroleum,624256,0,624256
1994,TN,Pumped Storage,0,-1185962,-1185962
1994,TN,Total,0,156669914,156669914
1994,TN,Wood and Wood Derived Fuels,923018,0,923018
1994,TX,Coal,250291314,0,250291314
1994,TX,Hydroelectric Conventional,0,3060872,3060872
1994,TX,Natural Gas,288881136,0,288881136
1994,TX,Nuclear,0,57490948,57490948
1994,TX,Other,478520,0,478520
1994,TX,Other Biomass,776546,0,776546
1994,TX,Other Gases,7078908,0,7078908
1994,TX,Petroleum,3919782,0,3919782
1994,TX,Solar Thermal and Photovoltaic,0,586,586
1994,TX,Total,0,614359048,614359048
1994,TX,Wood and Wood Derived Fuels,2380436,0,2380436
1994,UT,Coal,66261328,0,66261328
1994,UT,Geothermal,389608,0,389608
1994,UT,Hydroelectric Conventional,0,1500876,1500876
1994,UT,Natural Gas,1614518,0,1614518
1994,UT,Other Gases,561138,0,561138
1994,UT,Petroleum,66200,0,66200
1994,UT,Pumped Storage,0,0,0
1994,UT,Total,0,70393668,70393668
1994,VA,Coal,53181310,0,53181310
1994,VA,Hydroelectric Conventional,0,2292232,2292232
1994,VA,Natural Gas,9362278,0,9362278
1994,VA,Nuclear,0,50857712,50857712
1994,VA,Other,6582,0,6582
1994,VA,Other Biomass,1310584,0,1310584
1994,VA,Petroleum,5780382,0,5780382
1994,VA,Pumped Storage,0,-1484470,-1484470
1994,VA,Solar Thermal and Photovoltaic,0,22,22
1994,VA,Total,0,124097848,124097848
1994,VA,Wood and Wood Derived Fuels,2791216,0,2791216
1994,VT,Hydroelectric Conventional,0,2077306,2077306
1994,VT,Natural Gas,11612,0,11612
1994,VT,Nuclear,0,8631088,8631088
1994,VT,Petroleum,12708,0,12708
1994,VT,Total,0,11234060,11234060
1994,VT,Wind,0,0,0
1994,VT,Wood and Wood Derived Fuels,501346,0,501346
1994,WA,Coal,19662664,0,19662664
1994,WA,Hydroelectric Conventional,0,131150974,131150974
1994,WA,Natural Gas,9641164,0,9641164
1994,WA,Nuclear,0,13479498,13479498
1994,WA,Other,62564,0,62564
1994,WA,Other Biomass,449608,0,449608
1994,WA,Other Gases,598322,0,598322
1994,WA,Petroleum,90838,0,90838
1994,WA,Pumped Storage,0,0,0
1994,WA,Total,0,177172952,177172952
1994,WA,Wood and Wood Derived Fuels,2037320,0,2037320
1994,WI,Coal,72958038,0,72958038
1994,WI,Hydroelectric Conventional,0,4456618,4456618
1994,WI,Natural Gas,1209310,0,1209310
1994,WI,Nuclear,0,23032938,23032938
1994,WI,Other Biomass,416688,0,416688
1994,WI,Petroleum,859326,0,859326
1994,WI,Total,0,104717910,104717910
1994,WI,Wind,0,0,0
1994,WI,Wood and Wood Derived Fuels,1784992,0,1784992
1994,WV,Coal,159257132,0,159257132
1994,WV,Hydroelectric Conventional,0,2291270,2291270
1994,WV,Natural Gas,341078,0,341078
1994,WV,Other,408,0,408
1994,WV,Other Gases,425416,0,425416
1994,WV,Petroleum,543780,0,543780
1994,WV,Total,0,162859084,162859084
1994,WY,Coal,83148478,0,83148478
1994,WY,Hydroelectric Conventional,0,1794418,1794418
1994,WY,Natural Gas,801712,0,801712
1994,WY,Other,109492,0,109492
1994,WY,Other Gases,6448,0,6448
1994,WY,Petroleum,107142,0,107142
1994,WY,Total,0,86004570,86004570
1994,WY,Wood and Wood Derived Fuels,36880,0,36880
1995,AK,Coal,1057860,0,1057860
1995,AK,Hydroelectric Conventional,0,2744230,2744230
1995,AK,Natural Gas,6759146,0,6759146
1995,AK,Other Biomass,27178,0,27178
1995,AK,Petroleum,1241128,0,1241128
1995,AK,Total,0,12052232,12052232
1995,AK,Wind,0,0,0
1995,AK,Wood and Wood Derived Fuels,222690,0,222690
1995,AL,Coal,138095268,0,138095268
1995,AL,Hydroelectric Conventional,0,19003020,19003020
1995,AL,Natural Gas,3066768,0,3066768
1995,AL,Nuclear,0,41504682,41504682
1995,AL,Other Biomass,14994,0,14994
1995,AL,Other Gases,694054,0,694054
1995,AL,Petroleum,403076,0,403076
1995,AL,Total,0,210378732,210378732
1995,AL,Wood and Wood Derived Fuels,7596870,0,7596870
1995,AR,Coal,43110872,0,43110872
1995,AR,Hydroelectric Conventional,0,6435428,6435428
1995,AR,Natural Gas,7818700,0,7818700
1995,AR,Nuclear,0,23315098,23315098
1995,AR,Other,7302,0,7302
1995,AR,Other Biomass,46504,0,46504
1995,AR,Petroleum,135308,0,135308
1995,AR,Pumped Storage,0,0,0
1995,AR,Total,0,83944176,83944176
1995,AR,Wood and Wood Derived Fuels,3074964,0,3074964
1995,AZ,Coal,63903318,0,63903318
1995,AZ,Hydroelectric Conventional,0,16576838,16576838
1995,AZ,Natural Gas,4385894,0,4385894
1995,AZ,Nuclear,0,53969014,53969014
1995,AZ,Petroleum,165114,0,165114
1995,AZ,Pumped Storage,0,380058,380058
1995,AZ,Total,0,139561878,139561878
1995,AZ,Wood and Wood Derived Fuels,181642,0,181642
1995,CA,Coal,5573688,0,5573688
1995,CA,Geothermal,22900598,0,22900598
1995,CA,Hydroelectric Conventional,0,96066260,96066260
1995,CA,Natural Gas,145157786,0,145157786
1995,CA,Nuclear,0,60491872,60491872
1995,CA,Other,31592,0,31592
1995,CA,Other Biomass,5515712,0,5515712
1995,CA,Other Gases,5189970,0,5189970
1995,CA,Petroleum,4582256,0,4582256
1995,CA,Pumped Storage,0,5013330,5013330
1995,CA,Solar Thermal and Photovoltaic,0,993130,993130
1995,CA,Total,0,362926682,362926682
1995,CA,Wind,0,6173514,6173514
1995,CA,Wood and Wood Derived Fuels,5236974,0,5236974
1995,CO,Coal,60985364,0,60985364
1995,CO,Hydroelectric Conventional,0,4262378,4262378
1995,CO,Natural Gas,5713576,0,5713576
1995,CO,Other Biomass,65820,0,65820
1995,CO,Petroleum,23424,0,23424
1995,CO,Pumped Storage,0,183906,183906
1995,CO,Total,0,71234468,71234468
1995,CT,Coal,7715110,0,7715110
1995,CT,Hydroelectric Conventional,0,727606,727606
1995,CT,Natural Gas,6038486,0,6038486
1995,CT,Nuclear,0,37497800,37497800
1995,CT,Other,0,0,0
1995,CT,Other Biomass,3831678,0,3831678
1995,CT,Other Gases,158,0,158
1995,CT,Petroleum,7158926,0,7158926
1995,CT,Pumped Storage,0,-24828,-24828
1995,CT,Total,0,62944936,62944936
1995,DC,Coal,0,0,0
1995,DC,Petroleum,377724,0,377724
1995,DC,Total,0,377724,377724
1995,DE,Coal,8877948,0,8877948
1995,DE,Natural Gas,6371118,0,6371118
1995,DE,Other,18564,0,18564
1995,DE,Other Gases,227654,0,227654
1995,DE,Petroleum,2570390,0,2570390
1995,DE,Total,0,18065674,18065674
1995,FL,Coal,131523682,0,131523682
1995,FL,Hydroelectric Conventional,0,461680,461680
1995,FL,Natural Gas,85510300,0,85510300
1995,FL,Nuclear,0,57481234,57481234
1995,FL,Other,4053974,0,4053974
1995,FL,Other Biomass,6679764,0,6679764
1995,FL,Other Gases,62956,0,62956
1995,FL,Petroleum,44575002,0,44575002
1995,FL,Total,0,334828744,334828744
1995,FL,Wood and Wood Derived Fuels,4480152,0,4480152
1995,GA,Coal,133884720,0,133884720
1995,GA,Hydroelectric Conventional,0,8393482,8393482
1995,GA,Natural Gas,2919768,0,2919768
1995,GA,Nuclear,0,61321252,61321252
1995,GA,Other Biomass,136388,0,136388
1995,GA,Petroleum,1699720,0,1699720
1995,GA,Pumped Storage,0,1074924,1074924
1995,GA,Total,0,215757192,215757192
1995,GA,Wood and Wood Derived Fuels,6326938,0,6326938
1995,HI,Coal,3122408,0,3122408
1995,HI,Geothermal,469042,0,469042
1995,HI,Hydroelectric Conventional,0,195620,195620
1995,HI,Other,4238,0,4238
1995,HI,Other Biomass,1277050,0,1277050
1995,HI,Other Gases,138614,0,138614
1995,HI,Petroleum,15357990,0,15357990
1995,HI,Total,0,20607966,20607966
1995,HI,Wind,0,40714,40714
1995,HI,Wood and Wood Derived Fuels,2290,0,2290
1995,IA,Coal,58819408,0,58819408
1995,IA,Hydroelectric Conventional,0,2005948,2005948
1995,IA,Natural Gas,959778,0,959778
1995,IA,Nuclear,0,7459940,7459940
1995,IA,Other Biomass,128270,0,128270
1995,IA,Petroleum,131722,0,131722
1995,IA,Total,0,69505856,69505856
1995,IA,Wind,0,234,234
1995,IA,Wood and Wood Derived Fuels,556,0,556
1995,ID,Coal,95054,0,95054
1995,ID,Hydroelectric Conventional,0,21978668,21978668
1995,ID,Natural Gas,334584,0,334584
1995,ID,Other,180560,0,180560
1995,ID,Other Biomass,25974,0,25974
1995,ID,Petroleum,1128,0,1128
1995,ID,Total,0,23689210,23689210
1995,ID,Wood and Wood Derived Fuels,1073242,0,1073242
1995,IL,Coal,128831660,0,128831660
1995,IL,Hydroelectric Conventional,0,247872,247872
1995,IL,Natural Gas,7948756,0,7948756
1995,IL,Nuclear,0,156961696,156961696
1995,IL,Other Biomass,682654,0,682654
1995,IL,Other Gases,793812,0,793812
1995,IL,Petroleum,1845008,0,1845008
1995,IL,Total,0,297315862,297315862
1995,IL,Wood and Wood Derived Fuels,4404,0,4404
1995,IN,Coal,209376132,0,209376132
1995,IN,Hydroelectric Conventional,0,934522,934522
1995,IN,Natural Gas,2907126,0,2907126
1995,IN,Other Biomass,168680,0,168680
1995,IN,Other Gases,4241990,0,4241990
1995,IN,Petroleum,685242,0,685242
1995,IN,Total,0,218313692,218313692
1995,KS,Coal,51793918,0,51793918
1995,KS,Hydroelectric Conventional,0,22428,22428
1995,KS,Natural Gas,4748930,0,4748930
1995,KS,Nuclear,0,20124354,20124354
1995,KS,Petroleum,151728,0,151728
1995,KS,Total,0,76841410,76841410
1995,KS,Wind,0,52,52
1995,KY,Coal,165078934,0,165078934
1995,KY,Hydroelectric Conventional,0,6846956,6846956
1995,KY,Natural Gas,136070,0,136070
1995,KY,Petroleum,261196,0,261196
1995,KY,Total,0,172331672,172331672
1995,KY,Wood and Wood Derived Fuels,8516,0,8516
1995,LA,Coal,37978948,0,37978948
1995,LA,Hydroelectric Conventional,0,1904288,1904288
1995,LA,Natural Gas,86435494,0,86435494
1995,LA,Nuclear,0,31371800,31371800
1995,LA,Other,1201296,0,1201296
1995,LA,Other Biomass,204474,0,204474
1995,LA,Other Gases,1964362,0,1964362
1995,LA,Petroleum,2972428,0,2972428
1995,LA,Total,0,169119448,169119448
1995,LA,Wood and Wood Derived Fuels,5086358,0,5086358
1995,MA,Coal,21396526,0,21396526
1995,MA,Hydroelectric Conventional,0,1737298,1737298
1995,MA,Natural Gas,28470020,0,28470020
1995,MA,Nuclear,0,8971690,8971690
1995,MA,Other Biomass,3771588,0,3771588
1995,MA,Petroleum,12302990,0,12302990
1995,MA,Pumped Storage,0,-1612406,-1612406
1995,MA,Total,0,75308962,75308962
1995,MA,Wind,0,0,0
1995,MA,Wood and Wood Derived Fuels,271256,0,271256
1995,MD,Coal,55190512,0,55190512
1995,MD,Hydroelectric Conventional,0,2884012,2884012
1995,MD,Natural Gas,3097768,0,3097768
1995,MD,Nuclear,0,25875942,25875942
1995,MD,Other Biomass,1002384,0,1002384
1995,MD,Other Gases,1371442,0,1371442
1995,MD,Petroleum,2958938,0,2958938
1995,MD,Total,0,92731286,92731286
1995,MD,Wood and Wood Derived Fuels,350288,0,350288
1995,ME,Coal,1081182,0,1081182
1995,ME,Hydroelectric Conventional,0,6707824,6707824
1995,ME,Natural Gas,14438,0,14438
1995,ME,Nuclear,0,395154,395154
1995,ME,Other Biomass,1125410,0,1125410
1995,ME,Other Gases,10580,0,10580
1995,ME,Petroleum,4064464,0,4064464
1995,ME,Total,0,19526102,19526102
1995,ME,Wood and Wood Derived Fuels,6127050,0,6127050
1995,MI,Coal,134401290,0,134401290
1995,MI,Hydroelectric Conventional,0,3194372,3194372
1995,MI,Natural Gas,23149708,0,23149708
1995,MI,Nuclear,0,48896794,48896794
1995,MI,Other,30572,0,30572
1995,MI,Other Biomass,1363074,0,1363074
1995,MI,Other Gases,2860,0,2860
1995,MI,Petroleum,1710508,0,1710508
1995,MI,Pumped Storage,0,-1463640,-1463640
1995,MI,Total,0,214889224,214889224
1995,MI,Wood and Wood Derived Fuels,3603686,0,3603686
1995,MN,Coal,56127878,0,56127878
1995,MN,Hydroelectric Conventional,0,2196250,2196250
1995,MN,Natural Gas,2060814,0,2060814
1995,MN,Nuclear,0,26486938,26486938
1995,MN,Other Biomass,1427550,0,1427550
1995,MN,Petroleum,989652,0,989652
1995,MN,Total,0,90341768,90341768
1995,MN,Wind,0,113994,113994
1995,MN,Wood and Wood Derived Fuels,938692,0,938692
1995,MO,Coal,107720840,0,107720840
1995,MO,Hydroelectric Conventional,0,3837014,3837014
1995,MO,Natural Gas,2086880,0,2086880
1995,MO,Nuclear,0,16483666,16483666
1995,MO,Other Biomass,50956,0,50956
1995,MO,Petroleum,1392522,0,1392522
1995,MO,Pumped Storage,0,-129962,-129962
1995,MO,Total,0,131441916,131441916
1995,MS,Coal,18649904,0,18649904
1995,MS,Natural Gas,19442340,0,19442340
1995,MS,Nuclear,0,16026642,16026642
1995,MS,Other Biomass,1694,0,1694
1995,MS,Petroleum,75560,0,75560
1995,MS,Total,0,57961722,57961722
1995,MS,Wood and Wood Derived Fuels,3765582,0,3765582
1995,MT,Coal,29868294,0,29868294
1995,MT,Hydroelectric Conventional,0,21491706,21491706
1995,MT,Natural Gas,97476,0,97476
1995,MT,Other Gases,17356,0,17356
1995,MT,Petroleum,336108,0,336108
1995,MT,Total,0,51922628,51922628
1995,MT,Wood and Wood Derived Fuels,111688,0,111688
1995,NC,Coal,122969996,0,122969996
1995,NC,Hydroelectric Conventional,0,11041620,11041620
1995,NC,Natural Gas,1543376,0,1543376
1995,NC,Nuclear,0,71820390,71820390
1995,NC,Other,518260,0,518260
1995,NC,Other Biomass,109558,0,109558
1995,NC,Petroleum,959236,0,959236
1995,NC,Pumped Storage,0,334634,334634
1995,NC,Total,0,212589312,212589312
1995,NC,Wood and Wood Derived Fuels,3292242,0,3292242
1995,ND,Coal,52847742,0,52847742
1995,ND,Hydroelectric Conventional,0,4914802,4914802
1995,ND,Natural Gas,-696,0,-696
1995,ND,Other Biomass,43918,0,43918
1995,ND,Other Gases,87346,0,87346
1995,ND,Petroleum,115382,0,115382
1995,ND,Total,0,58008494,58008494
1995,NE,Coal,32208838,0,32208838
1995,NE,Hydroelectric Conventional,0,2852116,2852116
1995,NE,Natural Gas,490856,0,490856
1995,NE,Nuclear,0,14970896,14970896
1995,NE,Other Biomass,32536,0,32536
1995,NE,Petroleum,53358,0,53358
1995,NE,Total,0,50608600,50608600
1995,NH,Coal,6734976,0,6734976
1995,NH,Hydroelectric Conventional,0,2739780,2739780
1995,NH,Natural Gas,402608,0,402608
1995,NH,Nuclear,0,16758752,16758752
1995,NH,Other Biomass,350616,0,350616
1995,NH,Petroleum,2129512,0,2129512
1995,NH,Total,0,30868758,30868758
1995,NH,Wood and Wood Derived Fuels,1752514,0,1752514
1995,NJ,Coal,14331960,0,14331960
1995,NJ,Hydroelectric Conventional,0,21910,21910
1995,NJ,Natural Gas,36405042,0,36405042
1995,NJ,Nuclear,0,33611034,33611034
1995,NJ,Other Biomass,2443712,0,2443712
1995,NJ,Other Gases,128146,0,128146
1995,NJ,Petroleum,3444576,0,3444576
1995,NJ,Pumped Storage,0,-189064,-189064
1995,NJ,Total,0,90197316,90197316
1995,NM,Coal,52242894,0,52242894
1995,NM,Hydroelectric Conventional,0,527840,527840
1995,NM,Natural Gas,6817986,0,6817986
1995,NM,Other Biomass,18106,0,18106
1995,NM,Petroleum,55492,0,55492
1995,NM,Total,0,59662318,59662318
1995,NV,Coal,27943648,0,27943648
1995,NV,Geothermal,3107392,0,3107392
1995,NV,Hydroelectric Conventional,0,3883068,3883068
1995,NV,Natural Gas,12887506,0,12887506
1995,NV,Other,53268,0,53268
1995,NV,Petroleum,53106,0,53106
1995,NV,Total,0,47927988,47927988
1995,NY,Coal,44577826,0,44577826
1995,NY,Hydroelectric Conventional,0,51986394,51986394
1995,NY,Natural Gas,98113012,0,98113012
1995,NY,Nuclear,0,52672344,52672344
1995,NY,Other Biomass,3938880,0,3938880
1995,NY,Other Gases,193346,0,193346
1995,NY,Petroleum,16536580,0,16536580
1995,NY,Pumped Storage,0,-2324026,-2324026
1995,NY,Total,0,266826562,266826562
1995,NY,Wood and Wood Derived Fuels,1132206,0,1132206
1995,OH,Coal,241258856,0,241258856
1995,OH,Hydroelectric Conventional,0,464442,464442
1995,OH,Natural Gas,1449642,0,1449642
1995,OH,Nuclear,0,33536100,33536100
1995,OH,Other Biomass,43720,0,43720
1995,OH,Other Gases,278138,0,278138
1995,OH,Petroleum,660128,0,660128
1995,OH,Total,0,278687804,278687804
1995,OH,Wood and Wood Derived Fuels,996778,0,996778
1995,OK,Coal,65570124,0,65570124
1995,OK,Hydroelectric Conventional,0,5559840,5559840
1995,OK,Natural Gas,33431014,0,33431014
1995,OK,Other Biomass,3316,0,3316
1995,OK,Other Gases,130000,0,130000
1995,OK,Petroleum,197370,0,197370
1995,OK,Pumped Storage,0,-129326,-129326
1995,OK,Total,0,105334734,105334734
1995,OK,Wood and Wood Derived Fuels,572396,0,572396
1995,OR,Coal,3104982,0,3104982
1995,OR,Hydroelectric Conventional,0,81528930,81528930
1995,OR,Natural Gas,4706950,0,4706950
1995,OR,Other Biomass,159200,0,159200
1995,OR,Petroleum,10054,0,10054
1995,OR,Total,0,90531106,90531106
1995,OR,Wood and Wood Derived Fuels,1020990,0,1020990
1995,PA,Coal,212669294,0,212669294
1995,PA,Hydroelectric Conventional,0,4060414,4060414
1995,PA,Natural Gas,9852366,0,9852366
1995,PA,Nuclear,0,132923070,132923070
1995,PA,Other,90560,0,90560
1995,PA,Other Biomass,3298984,0,3298984
1995,PA,Other Gases,1563330,0,1563330
1995,PA,Petroleum,7295198,0,7295198
1995,PA,Pumped Storage,0,-2480306,-2480306
1995,PA,Total,0,370902622,370902622
1995,PA,Wood and Wood Derived Fuels,1629712,0,1629712
1995,RI,Coal,0,0,0
1995,RI,Hydroelectric Conventional,0,18338,18338
1995,RI,Natural Gas,8644484,0,8644484
1995,RI,Other Biomass,159458,0,159458
1995,RI,Petroleum,154146,0,154146
1995,RI,Total,0,8976426,8976426
1995,SC,Coal,52674380,0,52674380
1995,SC,Hydroelectric Conventional,0,6914286,6914286
1995,SC,Natural Gas,1379764,0,1379764
1995,SC,Nuclear,0,98346952,98346952
1995,SC,Other Biomass,134736,0,134736
1995,SC,Other Gases,18508,0,18508
1995,SC,Petroleum,514880,0,514880
1995,SC,Pumped Storage,0,-1315790,-1315790
1995,SC,Total,0,161827296,161827296
1995,SC,Wood and Wood Derived Fuels,3159580,0,3159580
1995,SD,Coal,5442590,0,5442590
1995,SD,Hydroelectric Conventional,0,12019742,12019742
1995,SD,Natural Gas,126278,0,126278
1995,SD,Petroleum,34976,0,34976
1995,SD,Total,0,17623586,17623586
1995,TN,Coal,118950008,0,118950008
1995,TN,Hydroelectric Conventional,0,19257102,19257102
1995,TN,Natural Gas,950190,0,950190
1995,TN,Nuclear,0,31416842,31416842
1995,TN,Other,316126,0,316126
1995,TN,Other Biomass,117408,0,117408
1995,TN,Other Gases,22124,0,22124
1995,TN,Petroleum,514770,0,514770
1995,TN,Pumped Storage,0,-1230978,-1230978
1995,TN,Total,0,171461670,171461670
1995,TN,Wood and Wood Derived Fuels,1148078,0,1148078
1995,TX,Coal,249433896,0,249433896
1995,TX,Hydroelectric Conventional,0,3406696,3406696
1995,TX,Natural Gas,293957416,0,293957416
1995,TX,Nuclear,0,72302650,72302650
1995,TX,Other,1579126,0,1579126
1995,TX,Other Biomass,149520,0,149520
1995,TX,Other Gases,8552308,0,8552308
1995,TX,Petroleum,3215590,0,3215590
1995,TX,Solar Thermal and Photovoltaic,0,506,506
1995,TX,Total,0,635272492,635272492
1995,TX,Wood and Wood Derived Fuels,2674784,0,2674784
1995,UT,Coal,61222126,0,61222126
1995,UT,Geothermal,279484,0,279484
1995,UT,Hydroelectric Conventional,0,1937486,1937486
1995,UT,Natural Gas,1582424,0,1582424
1995,UT,Other Gases,521388,0,521388
1995,UT,Petroleum,71868,0,71868
1995,UT,Pumped Storage,0,0,0
1995,UT,Total,0,65614776,65614776
1995,VA,Coal,56994130,0,56994130
1995,VA,Hydroelectric Conventional,0,1990052,1990052
1995,VA,Natural Gas,10863690,0,10863690
1995,VA,Nuclear,0,50269662,50269662
1995,VA,Other,10732,0,10732
1995,VA,Other Biomass,1397666,0,1397666
1995,VA,Petroleum,3201358,0,3201358
1995,VA,Pumped Storage,0,-1536788,-1536788
1995,VA,Solar Thermal and Photovoltaic,0,6,6
1995,VA,Total,0,125992042,125992042
1995,VA,Wood and Wood Derived Fuels,2801534,0,2801534
1995,VT,Hydroelectric Conventional,0,1945314,1945314
1995,VT,Natural Gas,13186,0,13186
1995,VT,Nuclear,0,7717018,7717018
1995,VT,Petroleum,26968,0,26968
1995,VT,Total,0,10320124,10320124
1995,VT,Wind,0,0,0
1995,VT,Wood and Wood Derived Fuels,617638,0,617638
1995,WA,Coal,11805890,0,11805890
1995,WA,Hydroelectric Conventional,0,165000306,165000306
1995,WA,Natural Gas,9779208,0,9779208
1995,WA,Nuclear,0,13883756,13883756
1995,WA,Other,358,0,358
1995,WA,Other Biomass,394576,0,394576
1995,WA,Other Gases,1101672,0,1101672
1995,WA,Petroleum,357830,0,357830
1995,WA,Pumped Storage,0,0,0
1995,WA,Total,0,204395172,204395172
1995,WA,Wood and Wood Derived Fuels,2071576,0,2071576
1995,WI,Coal,76186868,0,76186868
1995,WI,Hydroelectric Conventional,0,4756944,4756944
1995,WI,Natural Gas,2017208,0,2017208
1995,WI,Nuclear,0,21939212,21939212
1995,WI,Other,1168,0,1168
1995,WI,Other Biomass,466242,0,466242
1995,WI,Petroleum,770328,0,770328
1995,WI,Total,0,107846262,107846262
1995,WI,Wind,0,0,0
1995,WI,Wood and Wood Derived Fuels,1708292,0,1708292
1995,WV,Coal,157428438,0,157428438
1995,WV,Hydroelectric Conventional,0,2385358,2385358
1995,WV,Natural Gas,425748,0,425748
1995,WV,Other,428,0,428
1995,WV,Other Gases,409326,0,409326
1995,WV,Petroleum,425556,0,425556
1995,WV,Total,0,161074854,161074854
1995,WY,Coal,77992750,0,77992750
1995,WY,Hydroelectric Conventional,0,1597006,1597006
1995,WY,Natural Gas,644900,0,644900
1995,WY,Other,109492,0,109492
1995,WY,Other Gases,18460,0,18460
1995,WY,Petroleum,140610,0,140610
1995,WY,Total,0,80503218,80503218
1996,AK,Coal,857472,0,857472
1996,AK,Hydroelectric Conventional,0,2531726,2531726
1996,AK,Natural Gas,7097436,0,7097436
1996,AK,Other Biomass,23970,0,23970
1996,AK,Petroleum,1541352,0,1541352
1996,AK,Total,0,12257784,12257784
1996,AK,Wind,0,0,0
1996,AK,Wood and Wood Derived Fuels,205828,0,205828
1996,AL,Coal,148182970,0,148182970
1996,AL,Hydroelectric Conventional,0,22163842,22163842
1996,AL,Natural Gas,3768478,0,3768478
1996,AL,Nuclear,0,59415070,59415070
1996,AL,Other Biomass,14572,0,14572
1996,AL,Other Gases,614112,0,614112
1996,AL,Petroleum,630756,0,630756
1996,AL,Total,0,242945822,242945822
1996,AL,Wood and Wood Derived Fuels,8156022,0,8156022
1996,AR,Coal,48776834,0,48776834
1996,AR,Hydroelectric Conventional,0,5593932,5593932
1996,AR,Natural Gas,7587468,0,7587468
1996,AR,Nuclear,0,26713342,26713342
1996,AR,Other Biomass,42242,0,42242
1996,AR,Petroleum,227914,0,227914
1996,AR,Pumped Storage,0,0,0
1996,AR,Total,0,92067126,92067126
1996,AR,Wood and Wood Derived Fuels,3125394,0,3125394
1996,AZ,Coal,62065082,0,62065082
1996,AZ,Hydroelectric Conventional,0,18428712,18428712
1996,AZ,Natural Gas,4312764,0,4312764
1996,AZ,Nuclear,0,57679174,57679174
1996,AZ,Petroleum,139620,0,139620
1996,AZ,Pumped Storage,0,530794,530794
1996,AZ,Total,0,143309636,143309636
1996,AZ,Wood and Wood Derived Fuels,153490,0,153490
1996,CA,Coal,5057572,0,5057572
1996,CA,Geothermal,24680208,0,24680208
1996,CA,Hydroelectric Conventional,0,89502686,89502686
1996,CA,Natural Gas,128828358,0,128828358
1996,CA,Nuclear,0,68193720,68193720
1996,CA,Other,56558,0,56558
1996,CA,Other Biomass,4642316,0,4642316
1996,CA,Other Gases,6433848,0,6433848
1996,CA,Petroleum,5665936,0,5665936
1996,CA,Pumped Storage,0,4388872,4388872
1996,CA,Solar Thermal and Photovoltaic,0,1041890,1041890
1996,CA,Total,0,350526408,350526408
1996,CA,Wind,0,6157848,6157848
1996,CA,Wood and Wood Derived Fuels,5876596,0,5876596
1996,CO,Coal,64372362,0,64372362
1996,CO,Hydroelectric Conventional,0,3640736,3640736
1996,CO,Natural Gas,6399328,0,6399328
1996,CO,Other Biomass,66168,0,66168
1996,CO,Petroleum,36310,0,36310
1996,CO,Pumped Storage,0,-240184,-240184
1996,CO,Total,0,74274720,74274720
1996,CT,Coal,7884668,0,7884668
1996,CT,Hydroelectric Conventional,0,1251846,1251846
1996,CT,Natural Gas,3898486,0,3898486
1996,CT,Nuclear,0,12450466,12450466
1996,CT,Other,0,0,0
1996,CT,Other Biomass,4145738,0,4145738
1996,CT,Other Gases,128,0,128
1996,CT,Petroleum,10790690,0,10790690
1996,CT,Pumped Storage,0,774,774
1996,CT,Total,0,40422796,40422796
1996,DC,Petroleum,219618,0,219618
1996,DC,Total,0,219618,219618
1996,DE,Coal,8821528,0,8821528
1996,DE,Natural Gas,5433626,0,5433626
1996,DE,Other Gases,315590,0,315590
1996,DE,Petroleum,3138154,0,3138154
1996,DE,Total,0,17708898,17708898
1996,FL,Coal,141713578,0,141713578
1996,FL,Hydroelectric Conventional,0,431120,431120
1996,FL,Natural Gas,78469370,0,78469370
1996,FL,Nuclear,0,50940582,50940582
1996,FL,Other,4089882,0,4089882
1996,FL,Other Biomass,6862326,0,6862326
1996,FL,Other Gases,58612,0,58612
1996,FL,Petroleum,46769026,0,46769026
1996,FL,Total,0,334169872,334169872
1996,FL,Wood and Wood Derived Fuels,4835376,0,4835376
1996,GA,Coal,128471932,0,128471932
1996,GA,Hydroelectric Conventional,0,9357920,9357920
1996,GA,Natural Gas,2037956,0,2037956
1996,GA,Nuclear,0,59850002,59850002
1996,GA,Other Biomass,203542,0,203542
1996,GA,Other Gases,248,0,248
1996,GA,Petroleum,2051776,0,2051776
1996,GA,Pumped Storage,0,620204,620204
1996,GA,Total,0,208640082,208640082
1996,GA,Wood and Wood Derived Fuels,6046502,0,6046502
1996,HI,Coal,3286206,0,3286206
1996,HI,Geothermal,483970,0,483970
1996,HI,Hydroelectric Conventional,0,208064,208064
1996,HI,Other Biomass,1183530,0,1183530
1996,HI,Other Gases,120730,0,120730
1996,HI,Petroleum,15926234,0,15926234
1996,HI,Total,0,21255788,21255788
1996,HI,Wind,0,45056,45056
1996,HI,Wood and Wood Derived Fuels,1998,0,1998
1996,IA,Coal,58685900,0,58685900
1996,IA,Hydroelectric Conventional,0,1870666,1870666
1996,IA,Natural Gas,698934,0,698934
1996,IA,Nuclear,0,7847262,7847262
1996,IA,Other Biomass,137520,0,137520
1996,IA,Petroleum,134810,0,134810
1996,IA,Total,0,69377230,69377230
1996,IA,Wind,0,216,216
1996,IA,Wood and Wood Derived Fuels,1922,0,1922
1996,ID,Coal,60124,0,60124
1996,ID,Hydroelectric Conventional,0,26566496,26566496
1996,ID,Natural Gas,335700,0,335700
1996,ID,Other,191208,0,191208
1996,ID,Other Biomass,7366,0,7366
1996,ID,Petroleum,2568,0,2568
1996,ID,Total,0,28179616,28179616
1996,ID,Wood and Wood Derived Fuels,1016154,0,1016154
1996,IL,Coal,146696150,0,146696150
1996,IL,Hydroelectric Conventional,0,211178,211178
1996,IL,Natural Gas,5627536,0,5627536
1996,IL,Nuclear,0,139548712,139548712
1996,IL,Other Biomass,918828,0,918828
1996,IL,Other Gases,798986,0,798986
1996,IL,Petroleum,1659526,0,1659526
1996,IL,Total,0,295466058,295466058
1996,IL,Wood and Wood Derived Fuels,5142,0,5142
1996,IN,Coal,210898050,0,210898050
1996,IN,Hydroelectric Conventional,0,896728,896728
1996,IN,Natural Gas,2492350,0,2492350
1996,IN,Other Biomass,208292,0,208292
1996,IN,Other Gases,4106724,0,4106724
1996,IN,Petroleum,1202060,0,1202060
1996,IN,Total,0,219804204,219804204
1996,KS,Coal,59485444,0,59485444
1996,KS,Hydroelectric Conventional,0,21938,21938
1996,KS,Natural Gas,3648206,0,3648206
1996,KS,Nuclear,0,16409736,16409736
1996,KS,Petroleum,318988,0,318988
1996,KS,Total,0,79884312,79884312
1996,KY,Coal,169319636,0,169319636
1996,KY,Hydroelectric Conventional,0,6993978,6993978
1996,KY,Natural Gas,291960,0,291960
1996,KY,Petroleum,270874,0,270874
1996,KY,Total,0,176894992,176894992
1996,KY,Wood and Wood Derived Fuels,18544,0,18544
1996,LA,Coal,37402068,0,37402068
1996,LA,Hydroelectric Conventional,0,1927848,1927848
1996,LA,Natural Gas,73129550,0,73129550
1996,LA,Nuclear,0,31529646,31529646
1996,LA,Other,587084,0,587084
1996,LA,Other Biomass,192078,0,192078
1996,LA,Other Gases,1689176,0,1689176
1996,LA,Petroleum,3406896,0,3406896
1996,LA,Total,0,155479792,155479792
1996,LA,Wood and Wood Derived Fuels,5615446,0,5615446
1996,MA,Coal,23161542,0,23161542
1996,MA,Hydroelectric Conventional,0,2377250,2377250
1996,MA,Natural Gas,23859016,0,23859016
1996,MA,Nuclear,0,10648682,10648682
1996,MA,Other,22,0,22
1996,MA,Other Biomass,3867932,0,3867932
1996,MA,Petroleum,13033766,0,13033766
1996,MA,Pumped Storage,0,-1315934,-1315934
1996,MA,Total,0,75908040,75908040
1996,MA,Wind,0,0,0
1996,MA,Wood and Wood Derived Fuels,275764,0,275764
1996,MD,Coal,55984010,0,55984010
1996,MD,Hydroelectric Conventional,0,4914926,4914926
1996,MD,Natural Gas,1975254,0,1975254
1996,MD,Nuclear,0,24185536,24185536
1996,MD,Other Biomass,1131676,0,1131676
1996,MD,Other Gases,1078670,0,1078670
1996,MD,Petroleum,2944054,0,2944054
1996,MD,Total,0,92549234,92549234
1996,MD,Wood and Wood Derived Fuels,335108,0,335108
1996,ME,Coal,1019044,0,1019044
1996,ME,Hydroelectric Conventional,0,8314788,8314788
1996,ME,Natural Gas,6460,0,6460
1996,ME,Nuclear,0,10124034,10124034
1996,ME,Other,2,0,2
1996,ME,Other Biomass,1122898,0,1122898
1996,ME,Other Gases,11082,0,11082
1996,ME,Petroleum,3321708,0,3321708
1996,ME,Total,0,29868746,29868746
1996,ME,Wood and Wood Derived Fuels,5948730,0,5948730
1996,MI,Coal,135744304,0,135744304
1996,MI,Hydroelectric Conventional,0,3567062,3567062
1996,MI,Natural Gas,26029232,0,26029232
1996,MI,Nuclear,0,53658726,53658726
1996,MI,Other,30164,0,30164
1996,MI,Other Biomass,1815096,0,1815096
1996,MI,Other Gases,476832,0,476832
1996,MI,Petroleum,1665498,0,1665498
1996,MI,Pumped Storage,0,-1640672,-1640672
1996,MI,Total,0,225036618,225036618
1996,MI,Wood and Wood Derived Fuels,3690376,0,3690376
1996,MN,Coal,56845208,0,56845208
1996,MN,Hydroelectric Conventional,0,2374228,2374228
1996,MN,Natural Gas,1573340,0,1573340
1996,MN,Nuclear,0,24190244,24190244
1996,MN,Other Biomass,1395370,0,1395370
1996,MN,Petroleum,1303488,0,1303488
1996,MN,Total,0,88656878,88656878
1996,MN,Wind,0,99876,99876
1996,MN,Wood and Wood Derived Fuels,875124,0,875124
1996,MO,Coal,114836504,0,114836504
1996,MO,Hydroelectric Conventional,0,2627476,2627476
1996,MO,Natural Gas,856330,0,856330
1996,MO,Nuclear,0,17780754,17780754
1996,MO,Other Biomass,71628,0,71628
1996,MO,Petroleum,222414,0,222414
1996,MO,Pumped Storage,0,-150050,-150050
1996,MO,Total,0,136245056,136245056
1996,MS,Coal,24117790,0,24117790
1996,MS,Natural Gas,14350410,0,14350410
1996,MS,Nuclear,0,18449186,18449186
1996,MS,Other Biomass,3838,0,3838
1996,MS,Petroleum,2389858,0,2389858
1996,MS,Total,0,62554564,62554564
1996,MS,Wood and Wood Derived Fuels,3243482,0,3243482
1996,MT,Coal,24925012,0,24925012
1996,MT,Hydroelectric Conventional,0,27589862,27589862
1996,MT,Natural Gas,110498,0,110498
1996,MT,Other Gases,54132,0,54132
1996,MT,Petroleum,889896,0,889896
1996,MT,Total,0,53674850,53674850
1996,MT,Wood and Wood Derived Fuels,105450,0,105450
1996,NC,Coal,138662696,0,138662696
1996,NC,Hydroelectric Conventional,0,11904354,11904354
1996,NC,Natural Gas,940276,0,940276
1996,NC,Nuclear,0,67436364,67436364
1996,NC,Other,498820,0,498820
1996,NC,Other Biomass,111814,0,111814
1996,NC,Petroleum,1095662,0,1095662
1996,NC,Pumped Storage,0,680812,680812
1996,NC,Total,0,224395482,224395482
1996,NC,Wood and Wood Derived Fuels,3064684,0,3064684
1996,ND,Coal,55206792,0,55206792
1996,ND,Hydroelectric Conventional,0,6301746,6301746
1996,ND,Natural Gas,702,0,702
1996,ND,Other Biomass,15758,0,15758
1996,ND,Other Gases,87940,0,87940
1996,ND,Petroleum,204042,0,204042
1996,ND,Total,0,61816980,61816980
1996,NE,Coal,32134004,0,32134004
1996,NE,Hydroelectric Conventional,0,3203838,3203838
1996,NE,Natural Gas,387734,0,387734
1996,NE,Nuclear,0,18913628,18913628
1996,NE,Other Biomass,23068,0,23068
1996,NE,Petroleum,39946,0,39946
1996,NE,Total,0,54702218,54702218
1996,NH,Coal,6619390,0,6619390
1996,NH,Hydroelectric Conventional,0,3838410,3838410
1996,NH,Natural Gas,4198,0,4198
1996,NH,Nuclear,0,19689488,19689488
1996,NH,Other Biomass,362794,0,362794
1996,NH,Petroleum,1791488,0,1791488
1996,NH,Total,0,34127298,34127298
1996,NH,Wood and Wood Derived Fuels,1821530,0,1821530
1996,NJ,Coal,15663388,0,15663388
1996,NJ,Hydroelectric Conventional,0,38066,38066
1996,NJ,Natural Gas,33068966,0,33068966
1996,NJ,Nuclear,0,22055772,22055772
1996,NJ,Other Biomass,2026470,0,2026470
1996,NJ,Other Gases,326748,0,326748
1996,NJ,Petroleum,2482222,0,2482222
1996,NJ,Pumped Storage,0,-228466,-228466
1996,NJ,Total,0,75433166,75433166
1996,NM,Coal,52714358,0,52714358
1996,NM,Hydroelectric Conventional,0,422998,422998
1996,NM,Natural Gas,7110682,0,7110682
1996,NM,Other Biomass,19748,0,19748
1996,NM,Petroleum,54794,0,54794
1996,NM,Total,0,60322580,60322580
1996,NV,Coal,29313736,0,29313736
1996,NV,Geothermal,3109366,0,3109366
1996,NV,Hydroelectric Conventional,0,4328934,4328934
1996,NV,Natural Gas,14166512,0,14166512
1996,NV,Other,50308,0,50308
1996,NV,Petroleum,191960,0,191960
1996,NV,Total,0,51160816,51160816
1996,NY,Coal,45343578,0,45343578
1996,NY,Hydroelectric Conventional,0,57902500,57902500
1996,NY,Natural Gas,74898756,0,74898756
1996,NY,Nuclear,0,70451612,70451612
1996,NY,Other Biomass,4288976,0,4288976
1996,NY,Other Gases,211414,0,211414
1996,NY,Petroleum,19433196,0,19433196
1996,NY,Pumped Storage,0,-2291978,-2291978
1996,NY,Total,0,271464498,271464498
1996,NY,Wood and Wood Derived Fuels,1226444,0,1226444
1996,OH,Coal,257281886,0,257281886
1996,OH,Hydroelectric Conventional,0,794708,794708
1996,OH,Natural Gas,820538,0,820538
1996,OH,Nuclear,0,27838780,27838780
1996,OH,Other Biomass,11658,0,11658
1996,OH,Other Gases,353030,0,353030
1996,OH,Petroleum,607744,0,607744
1996,OH,Total,0,288874428,288874428
1996,OH,Wood and Wood Derived Fuels,1166084,0,1166084
1996,OK,Coal,69309062,0,69309062
1996,OK,Hydroelectric Conventional,0,4315550,4315550
1996,OK,Natural Gas,29343372,0,29343372
1996,OK,Other Biomass,3576,0,3576
1996,OK,Other Gases,120846,0,120846
1996,OK,Petroleum,280412,0,280412
1996,OK,Pumped Storage,0,-159188,-159188
1996,OK,Total,0,103699240,103699240
1996,OK,Wood and Wood Derived Fuels,485610,0,485610
1996,OR,Coal,3490348,0,3490348
1996,OR,Hydroelectric Conventional,0,89812916,89812916
1996,OR,Natural Gas,7621454,0,7621454
1996,OR,Other Biomass,127028,0,127028
1996,OR,Petroleum,15914,0,15914
1996,OR,Total,0,102023548,102023548
1996,OR,Wood and Wood Derived Fuels,955888,0,955888
1996,PA,Coal,222399412,0,222399412
1996,PA,Hydroelectric Conventional,0,6024156,6024156
1996,PA,Natural Gas,6186204,0,6186204
1996,PA,Nuclear,0,137344076,137344076
1996,PA,Other,106936,0,106936
1996,PA,Other Biomass,3498426,0,3498426
1996,PA,Other Gases,1496426,0,1496426
1996,PA,Petroleum,7182004,0,7182004
1996,PA,Pumped Storage,0,-1845036,-1845036
1996,PA,Total,0,383745246,383745246
1996,PA,Wood and Wood Derived Fuels,1352642,0,1352642
1996,RI,Coal,0,0,0
1996,RI,Hydroelectric Conventional,0,20734,20734
1996,RI,Natural Gas,14955730,0,14955730
1996,RI,Other Biomass,188482,0,188482
1996,RI,Petroleum,275126,0,275126
1996,RI,Total,0,15440072,15440072
1996,SC,Coal,61726632,0,61726632
1996,SC,Hydroelectric Conventional,0,6082128,6082128
1996,SC,Natural Gas,392652,0,392652
1996,SC,Nuclear,0,87142064,87142064
1996,SC,Other,7006,0,7006
1996,SC,Other Biomass,155668,0,155668
1996,SC,Other Gases,37066,0,37066
1996,SC,Petroleum,558414,0,558414
1996,SC,Pumped Storage,0,-1509964,-1509964
1996,SC,Total,0,157537104,157537104
1996,SC,Wood and Wood Derived Fuels,2945438,0,2945438
1996,SD,Coal,4059802,0,4059802
1996,SD,Hydroelectric Conventional,0,15955340,15955340
1996,SD,Natural Gas,99456,0,99456
1996,SD,Petroleum,17950,0,17950
1996,SD,Total,0,20132548,20132548
1996,TN,Coal,114359208,0,114359208
1996,TN,Hydroelectric Conventional,0,22933966,22933966
1996,TN,Natural Gas,500004,0,500004
1996,TN,Nuclear,0,45848478,45848478
1996,TN,Other,254946,0,254946
1996,TN,Other Biomass,120074,0,120074
1996,TN,Other Gases,29658,0,29658
1996,TN,Petroleum,520162,0,520162
1996,TN,Pumped Storage,0,-1356934,-1356934
1996,TN,Total,0,184244736,184244736
1996,TN,Wood and Wood Derived Fuels,1035174,0,1035174
1996,TX,Coal,271698216,0,271698216
1996,TX,Hydroelectric Conventional,0,1919684,1919684
1996,TX,Natural Gas,296066032,0,296066032
1996,TX,Nuclear,0,71533100,71533100
1996,TX,Other,1145016,0,1145016
1996,TX,Other Biomass,165464,0,165464
1996,TX,Other Gases,8817708,0,8817708
1996,TX,Petroleum,3823720,0,3823720
1996,TX,Solar Thermal and Photovoltaic,0,520,520
1996,TX,Total,0,657897866,657897866
1996,TX,Wind,0,165144,165144
1996,TX,Wood and Wood Derived Fuels,2563262,0,2563262
1996,UT,Coal,62201682,0,62201682
1996,UT,Geothermal,383824,0,383824
1996,UT,Hydroelectric Conventional,0,2097914,2097914
1996,UT,Natural Gas,647828,0,647828
1996,UT,Other Gases,477634,0,477634
1996,UT,Petroleum,94840,0,94840
1996,UT,Pumped Storage,0,0,0
1996,UT,Total,0,65903722,65903722
1996,VA,Coal,64963694,0,64963694
1996,VA,Hydroelectric Conventional,0,2857004,2857004
1996,VA,Natural Gas,7865494,0,7865494
1996,VA,Nuclear,0,52572566,52572566
1996,VA,Other Biomass,1801976,0,1801976
1996,VA,Other Gases,138,0,138
1996,VA,Petroleum,2550494,0,2550494
1996,VA,Pumped Storage,0,-1659206,-1659206
1996,VA,Solar Thermal and Photovoltaic,0,0,0
1996,VA,Total,0,133790254,133790254
1996,VA,Wood and Wood Derived Fuels,2838094,0,2838094
1996,VT,Hydroelectric Conventional,0,2462768,2462768
1996,VT,Natural Gas,194,0,194
1996,VT,Nuclear,0,7597580,7597580
1996,VT,Petroleum,7514,0,7514
1996,VT,Total,0,10700238,10700238
1996,VT,Wind,0,0,0
1996,VT,Wood and Wood Derived Fuels,632182,0,632182
1996,WA,Coal,16134254,0,16134254
1996,WA,Hydroelectric Conventional,0,197035710,197035710
1996,WA,Natural Gas,9414534,0,9414534
1996,WA,Nuclear,0,11176000,11176000
1996,WA,Other,3904,0,3904
1996,WA,Other Biomass,334738,0,334738
1996,WA,Other Gases,600442,0,600442
1996,WA,Petroleum,374472,0,374472
1996,WA,Pumped Storage,0,0,0
1996,WA,Total,0,237316264,237316264
1996,WA,Wood and Wood Derived Fuels,2242210,0,2242210
1996,WI,Coal,78539608,0,78539608
1996,WI,Hydroelectric Conventional,0,5392028,5392028
1996,WI,Natural Gas,1683724,0,1683724
1996,WI,Nuclear,0,20242710,20242710
1996,WI,Other,890,0,890
1996,WI,Other Biomass,510042,0,510042
1996,WI,Petroleum,727534,0,727534
1996,WI,Total,0,108835474,108835474
1996,WI,Wood and Wood Derived Fuels,1738938,0,1738938
1996,WV,Coal,170438012,0,170438012
1996,WV,Hydroelectric Conventional,0,2850070,2850070
1996,WV,Natural Gas,362198,0,362198
1996,WV,Other,432,0,432
1996,WV,Other Gases,374844,0,374844
1996,WV,Petroleum,463220,0,463220
1996,WV,Total,0,174488776,174488776
1996,WY,Coal,79460440,0,79460440
1996,WY,Hydroelectric Conventional,0,2463594,2463594
1996,WY,Natural Gas,755874,0,755874
1996,WY,Other,119382,0,119382
1996,WY,Other Gases,18860,0,18860
1996,WY,Petroleum,125842,0,125842
1996,WY,Total,0,82943992,82943992
1997,AK,Coal,885404,0,885404
1997,AK,Hydroelectric Conventional,0,2197906,2197906
1997,AK,Natural Gas,7415468,0,7415468
1997,AK,Other Biomass,10806,0,10806
1997,AK,Petroleum,1715778,0,1715778
1997,AK,Total,0,12309694,12309694
1997,AK,Wind,0,0,0
1997,AK,Wood and Wood Derived Fuels,84332,0,84332
1997,AL,Coal,144206636,0,144206636
1997,AL,Hydroelectric Conventional,0,23041274,23041274
1997,AL,Natural Gas,4219236,0,4219236
1997,AL,Nuclear,0,59145340,59145340
1997,AL,Other,740776,0,740776
1997,AL,Other Biomass,47186,0,47186
1997,AL,Other Gases,567756,0,567756
1997,AL,Petroleum,474830,0,474830
1997,AL,Total,0,239084664,239084664
1997,AL,Wood and Wood Derived Fuels,6641630,0,6641630
1997,AR,Coal,45620740,0,45620740
1997,AR,Hydroelectric Conventional,0,7031408,7031408
1997,AR,Natural Gas,5997968,0,5997968
1997,AR,Nuclear,0,28416314,28416314
1997,AR,Other Biomass,21626,0,21626
1997,AR,Other Gases,530,0,530
1997,AR,Petroleum,147806,0,147806
1997,AR,Pumped Storage,0,0,0
1997,AR,Total,0,90387200,90387200
1997,AR,Wood and Wood Derived Fuels,3150808,0,3150808
1997,AZ,Coal,68957696,0,68957696
1997,AZ,Hydroelectric Conventional,0,24098786,24098786
1997,AZ,Natural Gas,4967620,0,4967620
1997,AZ,Nuclear,0,58628400,58628400
1997,AZ,Petroleum,131362,0,131362
1997,AZ,Pumped Storage,0,704196,704196
1997,AZ,Solar Thermal and Photovoltaic,0,0,0
1997,AZ,Total,0,157650400,157650400
1997,AZ,Wood and Wood Derived Fuels,162340,0,162340
1997,CA,Coal,4663940,0,4663940
1997,CA,Geothermal,25432386,0,25432386
1997,CA,Hydroelectric Conventional,0,82109092,82109092
1997,CA,Natural Gas,142004128,0,142004128
1997,CA,Nuclear,0,61024236,61024236
1997,CA,Other,43360,0,43360
1997,CA,Other Biomass,4642610,0,4642610
1997,CA,Other Gases,5968554,0,5968554
1997,CA,Petroleum,4184384,0,4184384
1997,CA,Pumped Storage,0,2027808,2027808
1997,CA,Solar Thermal and Photovoltaic,0,1021912,1021912
1997,CA,Total,0,345595190,345595190
1997,CA,Wind,0,6273756,6273756
1997,CA,Wood and Wood Derived Fuels,6199024,0,6199024
1997,CO,Coal,64506040,0,64506040
1997,CO,Hydroelectric Conventional,0,4063622,4063622
1997,CO,Natural Gas,6544344,0,6544344
1997,CO,Other Biomass,65116,0,65116
1997,CO,Petroleum,30970,0,30970
1997,CO,Pumped Storage,0,75030,75030
1997,CO,Total,0,75285122,75285122
1997,CT,Coal,8318288,0,8318288
1997,CT,Hydroelectric Conventional,0,893390,893390
1997,CT,Natural Gas,5190728,0,5190728
1997,CT,Nuclear,0,-249444,-249444
1997,CT,Other,0,0,0
1997,CT,Other Biomass,4192998,0,4192998
1997,CT,Other Gases,102,0,102
1997,CT,Petroleum,17017418,0,17017418
1997,CT,Pumped Storage,0,-14884,-14884
1997,CT,Total,0,35348596,35348596
1997,DC,Petroleum,141322,0,141322
1997,DC,Total,0,141322,141322
1997,DE,Coal,8001168,0,8001168
1997,DE,Natural Gas,3657516,0,3657516
1997,DE,Other Gases,355584,0,355584
1997,DE,Petroleum,2431002,0,2431002
1997,DE,Total,0,14445270,14445270
1997,FL,Coal,141869010,0,141869010
1997,FL,Hydroelectric Conventional,0,482560,482560
1997,FL,Natural Gas,79751368,0,79751368
1997,FL,Nuclear,0,45935486,45935486
1997,FL,Other,4117652,0,4117652
1997,FL,Other Biomass,6611660,0,6611660
1997,FL,Other Gases,112418,0,112418
1997,FL,Petroleum,52319442,0,52319442
1997,FL,Total,0,336493986,336493986
1997,FL,Wood and Wood Derived Fuels,5294390,0,5294390
1997,GA,Coal,134351142,0,134351142
1997,GA,Hydroelectric Conventional,0,8559378,8559378
1997,GA,Natural Gas,2432216,0,2432216
1997,GA,Nuclear,0,60828988,60828988
1997,GA,Other,8388,0,8388
1997,GA,Other Biomass,122962,0,122962
1997,GA,Petroleum,1862336,0,1862336
1997,GA,Pumped Storage,0,379038,379038
1997,GA,Total,0,215251916,215251916
1997,GA,Wood and Wood Derived Fuels,6707468,0,6707468
1997,HI,Coal,3149462,0,3149462
1997,HI,Geothermal,490780,0,490780
1997,HI,Hydroelectric Conventional,0,230660,230660
1997,HI,Other Biomass,1211618,0,1211618
1997,HI,Other Gases,130766,0,130766
1997,HI,Petroleum,15378280,0,15378280
1997,HI,Total,0,20624494,20624494
1997,HI,Wind,0,32062,32062
1997,HI,Wood and Wood Derived Fuels,866,0,866
1997,IA,Coal,59666450,0,59666450
1997,IA,Hydroelectric Conventional,0,1609888,1609888
1997,IA,Natural Gas,875382,0,875382
1997,IA,Nuclear,0,8298222,8298222
1997,IA,Other Biomass,205438,0,205438
1997,IA,Petroleum,180384,0,180384
1997,IA,Total,0,70837880,70837880
1997,IA,Wind,0,236,236
1997,IA,Wood and Wood Derived Fuels,1880,0,1880
1997,ID,Coal,54924,0,54924
1997,ID,Hydroelectric Conventional,0,29351254,29351254
1997,ID,Natural Gas,625976,0,625976
1997,ID,Other,179900,0,179900
1997,ID,Other Biomass,18532,0,18532
1997,ID,Petroleum,23492,0,23492
1997,ID,Total,0,31178020,31178020
1997,ID,Wood and Wood Derived Fuels,923942,0,923942
1997,IL,Coal,156242534,0,156242534
1997,IL,Hydroelectric Conventional,0,194348,194348
1997,IL,Natural Gas,8565208,0,8565208
1997,IL,Nuclear,0,102137636,102137636
1997,IL,Other Biomass,1283082,0,1283082
1997,IL,Other Gases,722238,0,722238
1997,IL,Petroleum,1055844,0,1055844
1997,IL,Total,0,270281538,270281538
1997,IL,Wood and Wood Derived Fuels,80648,0,80648
1997,IN,Coal,220103326,0,220103326
1997,IN,Hydroelectric Conventional,0,1123186,1123186
1997,IN,Natural Gas,2466202,0,2466202
1997,IN,Other Biomass,248112,0,248112
1997,IN,Other Gases,3990694,0,3990694
1997,IN,Petroleum,1526294,0,1526294
1997,IN,Total,0,229457814,229457814
1997,KS,Coal,54471750,0,54471750
1997,KS,Hydroelectric Conventional,0,27762,27762
1997,KS,Natural Gas,4253022,0,4253022
1997,KS,Nuclear,0,16860910,16860910
1997,KS,Petroleum,221526,0,221526
1997,KS,Total,0,75834970,75834970
1997,KY,Coal,175750662,0,175750662
1997,KY,Hydroelectric Conventional,0,6760466,6760466
1997,KY,Natural Gas,353714,0,353714
1997,KY,Petroleum,251250,0,251250
1997,KY,Total,0,183144190,183144190
1997,KY,Wood and Wood Derived Fuels,28098,0,28098
1997,LA,Coal,42014242,0,42014242
1997,LA,Hydroelectric Conventional,0,2071922,2071922
1997,LA,Natural Gas,81153124,0,81153124
1997,LA,Nuclear,0,27022016,27022016
1997,LA,Other,355596,0,355596
1997,LA,Other Biomass,208848,0,208848
1997,LA,Other Gases,2176558,0,2176558
1997,LA,Petroleum,4572288,0,4572288
1997,LA,Total,0,165643286,165643286
1997,LA,Wood and Wood Derived Fuels,6068692,0,6068692
1997,MA,Coal,25052912,0,25052912
1997,MA,Hydroelectric Conventional,0,2063374,2063374
1997,MA,Natural Gas,27252340,0,27252340
1997,MA,Nuclear,0,8620862,8620862
1997,MA,Other Biomass,4023258,0,4023258
1997,MA,Petroleum,23624834,0,23624834
1997,MA,Pumped Storage,0,-976356,-976356
1997,MA,Total,0,89930656,89930656
1997,MA,Wind,0,0,0
1997,MA,Wood and Wood Derived Fuels,269432,0,269432
1997,MD,Coal,55241850,0,55241850
1997,MD,Hydroelectric Conventional,0,3176750,3176750
1997,MD,Natural Gas,2825170,0,2825170
1997,MD,Nuclear,0,26425934,26425934
1997,MD,Other Biomass,1175184,0,1175184
1997,MD,Other Gases,1128072,0,1128072
1997,MD,Petroleum,3130020,0,3130020
1997,MD,Total,0,93414792,93414792
1997,MD,Wood and Wood Derived Fuels,311812,0,311812
1997,ME,Coal,1224446,0,1224446
1997,ME,Hydroelectric Conventional,0,7295862,7295862
1997,ME,Natural Gas,6892,0,6892
1997,ME,Nuclear,0,0,0
1997,ME,Other Biomass,1075924,0,1075924
1997,ME,Other Gases,10146,0,10146
1997,ME,Petroleum,4970414,0,4970414
1997,ME,Total,0,20666812,20666812
1997,ME,Wood and Wood Derived Fuels,6083128,0,6083128
1997,MI,Coal,134889700,0,134889700
1997,MI,Hydroelectric Conventional,0,3424928,3424928
1997,MI,Natural Gas,26776624,0,26776624
1997,MI,Nuclear,0,43827616,43827616
1997,MI,Other,36244,0,36244
1997,MI,Other Biomass,1883264,0,1883264
1997,MI,Other Gases,1918,0,1918
1997,MI,Petroleum,1515306,0,1515306
1997,MI,Pumped Storage,0,-1868770,-1868770
1997,MI,Total,0,213941518,213941518
1997,MI,Wood and Wood Derived Fuels,3454688,0,3454688
1997,MN,Coal,57203410,0,57203410
1997,MN,Hydroelectric Conventional,0,2069394,2069394
1997,MN,Natural Gas,1545528,0,1545528
1997,MN,Nuclear,0,21638344,21638344
1997,MN,Other Biomass,1463102,0,1463102
1997,MN,Petroleum,1674774,0,1674774
1997,MN,Total,0,86480590,86480590
1997,MN,Wind,0,107908,107908
1997,MN,Wood and Wood Derived Fuels,778130,0,778130
1997,MO,Coal,120300560,0,120300560
1997,MO,Hydroelectric Conventional,0,3186618,3186618
1997,MO,Natural Gas,1196820,0,1196820
1997,MO,Nuclear,0,17909208,17909208
1997,MO,Other Biomass,106088,0,106088
1997,MO,Petroleum,279044,0,279044
1997,MO,Pumped Storage,0,-229968,-229968
1997,MO,Total,0,142748370,142748370
1997,MS,Coal,25093068,0,25093068
1997,MS,Natural Gas,12108254,0,12108254
1997,MS,Nuclear,0,21625124,21625124
1997,MS,Other Biomass,1964,0,1964
1997,MS,Petroleum,5288440,0,5288440
1997,MS,Total,0,67357904,67357904
1997,MS,Wood and Wood Derived Fuels,3241054,0,3241054
1997,MT,Coal,29232040,0,29232040
1997,MT,Hydroelectric Conventional,0,26812988,26812988
1997,MT,Natural Gas,97220,0,97220
1997,MT,Other Gases,61722,0,61722
1997,MT,Petroleum,873264,0,873264
1997,MT,Total,0,57173892,57173892
1997,MT,Wood and Wood Derived Fuels,96658,0,96658
1997,NC,Coal,148144082,0,148144082
1997,NC,Hydroelectric Conventional,0,11251768,11251768
1997,NC,Natural Gas,1399872,0,1399872
1997,NC,Nuclear,0,64906148,64906148
1997,NC,Other,472102,0,472102
1997,NC,Other Biomass,157142,0,157142
1997,NC,Petroleum,993018,0,993018
1997,NC,Pumped Storage,0,507610,507610
1997,NC,Total,0,230989378,230989378
1997,NC,Wood and Wood Derived Fuels,3157636,0,3157636
1997,ND,Coal,52779904,0,52779904
1997,ND,Hydroelectric Conventional,0,6639154,6639154
1997,ND,Natural Gas,782,0,782
1997,ND,Other Biomass,8278,0,8278
1997,ND,Other Gases,88634,0,88634
1997,ND,Petroleum,188454,0,188454
1997,ND,Total,0,59705206,59705206
1997,NE,Coal,34497274,0,34497274
1997,NE,Hydroelectric Conventional,0,3344838,3344838
1997,NE,Natural Gas,422602,0,422602
1997,NE,Nuclear,0,18537714,18537714
1997,NE,Other Biomass,33988,0,33988
1997,NE,Petroleum,62118,0,62118
1997,NE,Total,0,56898534,56898534
1997,NH,Coal,8154450,0,8154450
1997,NH,Hydroelectric Conventional,0,3243182,3243182
1997,NH,Natural Gas,93788,0,93788
1997,NH,Nuclear,0,15958896,15958896
1997,NH,Other Biomass,385608,0,385608
1997,NH,Petroleum,2139644,0,2139644
1997,NH,Total,0,31760446,31760446
1997,NH,Wood and Wood Derived Fuels,1784878,0,1784878
1997,NJ,Coal,17796412,0,17796412
1997,NJ,Hydroelectric Conventional,0,36742,36742
1997,NJ,Natural Gas,33975860,0,33975860
1997,NJ,Nuclear,0,27816148,27816148
1997,NJ,Other Biomass,2346352,0,2346352
1997,NJ,Other Gases,263964,0,263964
1997,NJ,Petroleum,1536090,0,1536090
1997,NJ,Pumped Storage,0,-259046,-259046
1997,NJ,Total,0,83512522,83512522
1997,NM,Coal,54157320,0,54157320
1997,NM,Hydroelectric Conventional,0,517620,517620
1997,NM,Natural Gas,8191354,0,8191354
1997,NM,Other Biomass,12424,0,12424
1997,NM,Petroleum,45996,0,45996
1997,NM,Total,0,62924714,62924714
1997,NV,Coal,30501212,0,30501212
1997,NV,Geothermal,3192002,0,3192002
1997,NV,Hydroelectric Conventional,0,5173948,5173948
1997,NV,Natural Gas,15115628,0,15115628
1997,NV,Other,16364,0,16364
1997,NV,Petroleum,63890,0,63890
1997,NV,Total,0,54063044,54063044
1997,NY,Coal,48117588,0,48117588
1997,NY,Hydroelectric Conventional,0,61235990,61235990
1997,NY,Natural Gas,92561832,0,92561832
1997,NY,Nuclear,0,59139236,59139236
1997,NY,Other Biomass,4214522,0,4214522
1997,NY,Other Gases,214822,0,214822
1997,NY,Petroleum,17176752,0,17176752
1997,NY,Pumped Storage,0,-2186306,-2186306
1997,NY,Total,0,281663296,281663296
1997,NY,Wood and Wood Derived Fuels,1188860,0,1188860
1997,OH,Coal,250870838,0,250870838
1997,OH,Hydroelectric Conventional,0,1014736,1014736
1997,OH,Natural Gas,937868,0,937868
1997,OH,Nuclear,0,30661660,30661660
1997,OH,Other Biomass,188,0,188
1997,OH,Other Gases,379534,0,379534
1997,OH,Petroleum,587816,0,587816
1997,OH,Total,0,285622496,285622496
1997,OH,Wood and Wood Derived Fuels,1169856,0,1169856
1997,OK,Coal,72065658,0,72065658
1997,OK,Hydroelectric Conventional,0,5842412,5842412
1997,OK,Natural Gas,27364658,0,27364658
1997,OK,Other Biomass,3654,0,3654
1997,OK,Other Gases,133580,0,133580
1997,OK,Petroleum,53584,0,53584
1997,OK,Pumped Storage,0,-194216,-194216
1997,OK,Total,0,105727954,105727954
1997,OK,Wood and Wood Derived Fuels,458624,0,458624
1997,OR,Coal,3039334,0,3039334
1997,OR,Hydroelectric Conventional,0,93407400,93407400
1997,OR,Natural Gas,7194938,0,7194938
1997,OR,Other Biomass,181142,0,181142
1997,OR,Petroleum,26754,0,26754
1997,OR,Total,0,104825708,104825708
1997,OR,Wood and Wood Derived Fuels,976140,0,976140
1997,PA,Coal,231009004,0,231009004
1997,PA,Hydroelectric Conventional,0,4498230,4498230
1997,PA,Natural Gas,5309808,0,5309808
1997,PA,Nuclear,0,135309176,135309176
1997,PA,Other,57910,0,57910
1997,PA,Other Biomass,3586568,0,3586568
1997,PA,Other Gases,1512378,0,1512378
1997,PA,Petroleum,5410218,0,5410218
1997,PA,Pumped Storage,0,-1262088,-1262088
1997,PA,Total,0,386926396,386926396
1997,PA,Wood and Wood Derived Fuels,1495192,0,1495192
1997,RI,Coal,0,0,0
1997,RI,Hydroelectric Conventional,0,15018,15018
1997,RI,Natural Gas,15016808,0,15016808
1997,RI,Other Biomass,209180,0,209180
1997,RI,Petroleum,178100,0,178100
1997,RI,Total,0,15419106,15419106
1997,SC,Coal,63148748,0,63148748
1997,SC,Hydroelectric Conventional,0,5916306,5916306
1997,SC,Natural Gas,581422,0,581422
1997,SC,Nuclear,0,89831028,89831028
1997,SC,Other,10090,0,10090
1997,SC,Other Biomass,135000,0,135000
1997,SC,Other Gases,2282,0,2282
1997,SC,Petroleum,728010,0,728010
1997,SC,Pumped Storage,0,-1710088,-1710088
1997,SC,Total,0,161656116,161656116
1997,SC,Wood and Wood Derived Fuels,3013318,0,3013318
1997,SD,Coal,6628136,0,6628136
1997,SD,Hydroelectric Conventional,0,18024520,18024520
1997,SD,Natural Gas,233274,0,233274
1997,SD,Petroleum,13072,0,13072
1997,SD,Total,0,24899002,24899002
1997,TN,Coal,121035394,0,121035394
1997,TN,Hydroelectric Conventional,0,22075996,22075996
1997,TN,Natural Gas,713174,0,713174
1997,TN,Nuclear,0,49295988,49295988
1997,TN,Other,230880,0,230880
1997,TN,Other Biomass,121820,0,121820
1997,TN,Other Gases,35110,0,35110
1997,TN,Petroleum,395220,0,395220
1997,TN,Pumped Storage,0,-1344188,-1344188
1997,TN,Total,0,193628146,193628146
1997,TN,Wood and Wood Derived Fuels,1068752,0,1068752
1997,TX,Coal,276982204,0,276982204
1997,TX,Hydroelectric Conventional,0,3581500,3581500
1997,TX,Natural Gas,303009536,0,303009536
1997,TX,Nuclear,0,74715294,74715294
1997,TX,Other,808474,0,808474
1997,TX,Other Biomass,177798,0,177798
1997,TX,Other Gases,7410496,0,7410496
1997,TX,Petroleum,3047672,0,3047672
1997,TX,Solar Thermal and Photovoltaic,0,424,424
1997,TX,Total,0,672639020,672639020
1997,TX,Wind,0,162108,162108
1997,TX,Wood and Wood Derived Fuels,2743514,0,2743514
1997,UT,Coal,65088006,0,65088006
1997,UT,Geothermal,337036,0,337036
1997,UT,Hydroelectric Conventional,0,2688322,2688322
1997,UT,Natural Gas,655132,0,655132
1997,UT,Other Gases,562034,0,562034
1997,UT,Petroleum,93894,0,93894
1997,UT,Pumped Storage,0,0,0
1997,UT,Total,0,69424424,69424424
1997,VA,Coal,68319862,0,68319862
1997,VA,Hydroelectric Conventional,0,2040552,2040552
1997,VA,Natural Gas,3760098,0,3760098
1997,VA,Nuclear,0,54168118,54168118
1997,VA,Other Biomass,2110786,0,2110786
1997,VA,Other Gases,132,0,132
1997,VA,Petroleum,5540088,0,5540088
1997,VA,Pumped Storage,0,-1727582,-1727582
1997,VA,Solar Thermal and Photovoltaic,0,0,0
1997,VA,Total,0,137030668,137030668
1997,VA,Wood and Wood Derived Fuels,2818614,0,2818614
1997,VT,Hydroelectric Conventional,0,2134884,2134884
1997,VT,Natural Gas,186,0,186
1997,VT,Nuclear,0,8533732,8533732
1997,VT,Petroleum,22412,0,22412
1997,VT,Total,0,11361076,11361076
1997,VT,Wind,0,0,0
1997,VT,Wood and Wood Derived Fuels,669862,0,669862
1997,WA,Coal,13981038,0,13981038
1997,WA,Hydroelectric Conventional,0,208341102,208341102
1997,WA,Natural Gas,5923322,0,5923322
1997,WA,Nuclear,0,12488270,12488270
1997,WA,Other Biomass,444966,0,444966
1997,WA,Other Gases,580990,0,580990
1997,WA,Petroleum,457178,0,457178
1997,WA,Pumped Storage,0,0,0
1997,WA,Total,0,244252334,244252334
1997,WA,Wood and Wood Derived Fuels,2035468,0,2035468
1997,WI,Coal,83952970,0,83952970
1997,WI,Hydroelectric Conventional,0,4966586,4966586
1997,WI,Natural Gas,2848708,0,2848708
1997,WI,Nuclear,0,7831742,7831742
1997,WI,Other Biomass,669364,0,669364
1997,WI,Petroleum,821498,0,821498
1997,WI,Total,0,102828016,102828016
1997,WI,Wood and Wood Derived Fuels,1737148,0,1737148
1997,WV,Coal,179691058,0,179691058
1997,WV,Hydroelectric Conventional,0,2277538,2277538
1997,WV,Natural Gas,433492,0,433492
1997,WV,Other,462,0,462
1997,WV,Other Gases,276008,0,276008
1997,WV,Petroleum,379196,0,379196
1997,WV,Total,0,183057754,183057754
1997,WY,Coal,78999586,0,78999586
1997,WY,Hydroelectric Conventional,0,2761426,2761426
1997,WY,Natural Gas,771124,0,771124
1997,WY,Other,145778,0,145778
1997,WY,Other Gases,14248,0,14248
1997,WY,Petroleum,126962,0,126962
1997,WY,Total,0,82819124,82819124
1998,AK,Coal,1049226,0,1049226
1998,AK,Hydroelectric Conventional,0,2226664,2226664
1998,AK,Natural Gas,6705790,0,6705790
1998,AK,Petroleum,1672934,0,1672934
1998,AK,Total,0,11657690,11657690
1998,AK,Wind,0,0,0
1998,AK,Wood and Wood Derived Fuels,3076,0,3076
1998,AL,Coal,143880072,0,143880072
1998,AL,Hydroelectric Conventional,0,21129714,21129714
1998,AL,Natural Gas,7503396,0,7503396
1998,AL,Nuclear,0,57325026,57325026
1998,AL,Other,2454,0,2454
1998,AL,Other Biomass,15916,0,15916
1998,AL,Other Gases,536004,0,536004
1998,AL,Petroleum,907348,0,907348
1998,AL,Total,0,239724250,239724250
1998,AL,Wood and Wood Derived Fuels,8424320,0,8424320
1998,AR,Coal,46360408,0,46360408
1998,AR,Hydroelectric Conventional,0,6233486,6233486
1998,AR,Natural Gas,9014158,0,9014158
1998,AR,Nuclear,0,26194504,26194504
1998,AR,Other Biomass,15574,0,15574
1998,AR,Other Gases,370,0,370
1998,AR,Petroleum,330698,0,330698
1998,AR,Pumped Storage,0,0,0
1998,AR,Total,0,91330602,91330602
1998,AR,Wood and Wood Derived Fuels,3181404,0,3181404
1998,AZ,Coal,73126854,0,73126854
1998,AZ,Hydroelectric Conventional,0,21940378,21940378
1998,AZ,Natural Gas,7856408,0,7856408
1998,AZ,Nuclear,0,60602090,60602090
1998,AZ,Petroleum,126432,0,126432
1998,AZ,Pumped Storage,0,537982,537982
1998,AZ,Solar Thermal and Photovoltaic,0,0,0
1998,AZ,Total,0,164190144,164190144
1998,CA,Coal,4318140,0,4318140
1998,CA,Geothermal,25679368,0,25679368
1998,CA,Hydroelectric Conventional,0,99096400,99096400
1998,CA,Natural Gas,150263984,0,150263984
1998,CA,Nuclear,0,69188412,69188412
1998,CA,Other,40450,0,40450
1998,CA,Other Biomass,4799422,0,4799422
1998,CA,Other Gases,6153112,0,6153112
1998,CA,Petroleum,4426144,0,4426144
1998,CA,Pumped Storage,0,2417602,2417602
1998,CA,Solar Thermal and Photovoltaic,0,1004678,1004678
1998,CA,Total,0,379201412,379201412
1998,CA,Wind,0,5515738,5515738
1998,CA,Wood and Wood Derived Fuels,6297962,0,6297962
1998,CO,Coal,66715698,0,66715698
1998,CO,Hydroelectric Conventional,0,2923922,2923922
1998,CO,Natural Gas,7872628,0,7872628
1998,CO,Other Biomass,61438,0,61438
1998,CO,Petroleum,98380,0,98380
1998,CO,Pumped Storage,0,91060,91060
1998,CO,Total,0,77763126,77763126
1998,CT,Coal,6032494,0,6032494
1998,CT,Hydroelectric Conventional,0,896570,896570
1998,CT,Natural Gas,4514936,0,4514936
1998,CT,Nuclear,0,6486006,6486006
1998,CT,Other,0,0,0
1998,CT,Other Biomass,4122158,0,4122158
1998,CT,Other Gases,478,0,478
1998,CT,Petroleum,17330164,0,17330164
1998,CT,Pumped Storage,0,178,178
1998,CT,Total,0,39382984,39382984
1998,DC,Petroleum,487950,0,487950
1998,DC,Total,0,487950,487950
1998,DE,Coal,7812354,0,7812354
1998,DE,Natural Gas,2553944,0,2553944
1998,DE,Other,8322,0,8322
1998,DE,Other Gases,375282,0,375282
1998,DE,Petroleum,3047268,0,3047268
1998,DE,Total,0,13797170,13797170
1998,FL,Coal,140558888,0,140558888
1998,FL,Hydroelectric Conventional,0,397010,397010
1998,FL,Natural Gas,77846382,0,77846382
1998,FL,Nuclear,0,62230838,62230838
1998,FL,Other,4086298,0,4086298
1998,FL,Other Biomass,6786736,0,6786736
1998,FL,Other Gases,160610,0,160610
1998,FL,Petroleum,83043302,0,83043302
1998,FL,Total,0,379257992,379257992
1998,FL,Wood and Wood Derived Fuels,4147928,0,4147928
1998,GA,Coal,141756104,0,141756104
1998,GA,Hydroelectric Conventional,0,10469042,10469042
1998,GA,Natural Gas,6586280,0,6586280
1998,GA,Nuclear,0,62760802,62760802
1998,GA,Other,13362,0,13362
1998,GA,Other Biomass,108696,0,108696
1998,GA,Petroleum,3142382,0,3142382
1998,GA,Pumped Storage,0,-345396,-345396
1998,GA,Total,0,230647412,230647412
1998,GA,Wood and Wood Derived Fuels,6156140,0,6156140
1998,HI,Coal,2869736,0,2869736
1998,HI,Geothermal,474166,0,474166
1998,HI,Hydroelectric Conventional,0,242546,242546
1998,HI,Other Biomass,1008132,0,1008132
1998,HI,Other Gases,120886,0,120886
1998,HI,Petroleum,15702136,0,15702136
1998,HI,Total,0,20456164,20456164
1998,HI,Wind,0,38562,38562
1998,IA,Coal,65999942,0,65999942
1998,IA,Hydroelectric Conventional,0,1825830,1825830
1998,IA,Natural Gas,1121784,0,1121784
1998,IA,Nuclear,0,7535026,7535026
1998,IA,Other Biomass,179754,0,179754
1998,IA,Petroleum,233086,0,233086
1998,IA,Total,0,76897578,76897578
1998,IA,Wind,0,178,178
1998,IA,Wood and Wood Derived Fuels,1978,0,1978
1998,ID,Coal,96240,0,96240
1998,ID,Hydroelectric Conventional,0,25871100,25871100
1998,ID,Natural Gas,674304,0,674304
1998,ID,Other,167028,0,167028
1998,ID,Other Biomass,100,0,100
1998,ID,Petroleum,1250,0,1250
1998,ID,Total,0,27817346,27817346
1998,ID,Wood and Wood Derived Fuels,1007324,0,1007324
1998,IL,Coal,150710322,0,150710322
1998,IL,Hydroelectric Conventional,0,275426,275426
1998,IL,Natural Gas,11048684,0,11048684
1998,IL,Nuclear,0,111191336,111191336
1998,IL,Other,38620,0,38620
1998,IL,Other Biomass,1251788,0,1251788
1998,IL,Other Gases,685648,0,685648
1998,IL,Petroleum,1724842,0,1724842
1998,IL,Total,0,276929124,276929124
1998,IL,Wood and Wood Derived Fuels,2458,0,2458
1998,IN,Coal,223636190,0,223636190
1998,IN,Hydroelectric Conventional,0,957336,957336
1998,IN,Natural Gas,4154308,0,4154308
1998,IN,Other Biomass,248222,0,248222
1998,IN,Other Gases,3792792,0,3792792
1998,IN,Petroleum,2154202,0,2154202
1998,IN,Total,0,234943050,234943050
1998,KS,Coal,56047374,0,56047374
1998,KS,Hydroelectric Conventional,0,22850,22850
1998,KS,Natural Gas,6033594,0,6033594
1998,KS,Nuclear,0,20821436,20821436
1998,KS,Petroleum,245202,0,245202
1998,KS,Total,0,83170456,83170456
1998,KY,Coal,173677604,0,173677604
1998,KY,Hydroelectric Conventional,0,6232036,6232036
1998,KY,Natural Gas,995216,0,995216
1998,KY,Petroleum,929896,0,929896
1998,KY,Total,0,181866056,181866056
1998,KY,Wood and Wood Derived Fuels,31304,0,31304
1998,LA,Coal,41563060,0,41563060
1998,LA,Hydroelectric Conventional,0,2125648,2125648
1998,LA,Natural Gas,89950392,0,89950392
1998,LA,Nuclear,0,32855002,32855002
1998,LA,Other,636186,0,636186
1998,LA,Other Biomass,306814,0,306814
1998,LA,Other Gases,1836132,0,1836132
1998,LA,Petroleum,4587040,0,4587040
1998,LA,Total,0,179297222,179297222
1998,LA,Wood and Wood Derived Fuels,5436948,0,5436948
1998,MA,Coal,22399516,0,22399516
1998,MA,Hydroelectric Conventional,0,2059482,2059482
1998,MA,Natural Gas,23243656,0,23243656
1998,MA,Nuclear,0,11396828,11396828
1998,MA,Other Biomass,3874132,0,3874132
1998,MA,Petroleum,29068732,0,29068732
1998,MA,Pumped Storage,0,-911170,-911170
1998,MA,Total,0,91367232,91367232
1998,MA,Wind,0,0,0
1998,MA,Wood and Wood Derived Fuels,236056,0,236056
1998,MD,Coal,58589454,0,58589454
1998,MD,Hydroelectric Conventional,0,3479474,3479474
1998,MD,Natural Gas,3981192,0,3981192
1998,MD,Nuclear,0,26661196,26661196
1998,MD,Other Biomass,1210092,0,1210092
1998,MD,Other Gases,164632,0,164632
1998,MD,Petroleum,6908700,0,6908700
1998,MD,Total,0,101306034,101306034
1998,MD,Wood and Wood Derived Fuels,311294,0,311294
1998,ME,Coal,1176724,0,1176724
1998,ME,Hydroelectric Conventional,0,7431932,7431932
1998,ME,Natural Gas,6738,0,6738
1998,ME,Nuclear,0,0,0
1998,ME,Other Biomass,1597394,0,1597394
1998,ME,Other Gases,9886,0,9886
1998,ME,Petroleum,6290326,0,6290326
1998,ME,Total,0,22006634,22006634
1998,ME,Wood and Wood Derived Fuels,5493634,0,5493634
1998,MI,Coal,140945314,0,140945314
1998,MI,Hydroelectric Conventional,0,2794236,2794236
1998,MI,Natural Gas,26170360,0,26170360
1998,MI,Nuclear,0,24988306,24988306
1998,MI,Other,39256,0,39256
1998,MI,Other Biomass,2004180,0,2004180
1998,MI,Other Gases,10588,0,10588
1998,MI,Petroleum,2343322,0,2343322
1998,MI,Pumped Storage,0,-1860698,-1860698
1998,MI,Total,0,200954788,200954788
1998,MI,Wind,0,0,0
1998,MI,Wood and Wood Derived Fuels,3519924,0,3519924
1998,MN,Coal,63613754,0,63613754
1998,MN,Hydroelectric Conventional,0,1909286,1909286
1998,MN,Natural Gas,3192064,0,3192064
1998,MN,Nuclear,0,23288212,23288212
1998,MN,Other Biomass,1540220,0,1540220
1998,MN,Petroleum,1334542,0,1334542
1998,MN,Total,0,96035810,96035810
1998,MN,Wind,0,293704,293704
1998,MN,Wood and Wood Derived Fuels,864028,0,864028
1998,MO,Coal,125452352,0,125452352
1998,MO,Hydroelectric Conventional,0,4693170,4693170
1998,MO,Natural Gas,2529620,0,2529620
1998,MO,Nuclear,0,17033546,17033546
1998,MO,Other Biomass,177768,0,177768
1998,MO,Petroleum,643642,0,643642
1998,MO,Pumped Storage,0,-155406,-155406
1998,MO,Total,0,150374692,150374692
1998,MS,Coal,23559086,0,23559086
1998,MS,Natural Gas,13153944,0,13153944
1998,MS,Nuclear,0,18381056,18381056
1998,MS,Other Biomass,1370,0,1370
1998,MS,Petroleum,10850444,0,10850444
1998,MS,Total,0,68818112,68818112
1998,MS,Wood and Wood Derived Fuels,2872212,0,2872212
1998,MT,Coal,33569572,0,33569572
1998,MT,Hydroelectric Conventional,0,22235880,22235880
1998,MT,Natural Gas,111552,0,111552
1998,MT,Other Gases,62272,0,62272
1998,MT,Petroleum,853462,0,853462
1998,MT,Total,0,56921036,56921036
1998,MT,Wood and Wood Derived Fuels,88298,0,88298
1998,NC,Coal,145898926,0,145898926
1998,NC,Hydroelectric Conventional,0,11476414,11476414
1998,NC,Natural Gas,2568714,0,2568714
1998,NC,Nuclear,0,77556422,77556422
1998,NC,Other,498712,0,498712
1998,NC,Other Biomass,176844,0,176844
1998,NC,Petroleum,1382628,0,1382628
1998,NC,Pumped Storage,0,131344,131344
1998,NC,Total,0,242757648,242757648
1998,NC,Wood and Wood Derived Fuels,3067644,0,3067644
1998,ND,Coal,56513720,0,56513720
1998,ND,Hydroelectric Conventional,0,4591896,4591896
1998,ND,Natural Gas,1458,0,1458
1998,ND,Other Biomass,3048,0,3048
1998,ND,Other Gases,104732,0,104732
1998,ND,Petroleum,129048,0,129048
1998,ND,Total,0,61343902,61343902
1998,NE,Coal,36760942,0,36760942
1998,NE,Hydroelectric Conventional,0,3365668,3365668
1998,NE,Natural Gas,828966,0,828966
1998,NE,Nuclear,0,16517606,16517606
1998,NE,Other Biomass,35186,0,35186
1998,NE,Petroleum,85214,0,85214
1998,NE,Total,0,57593582,57593582
1998,NE,Wind,0,0,0
1998,NH,Coal,7026130,0,7026130
1998,NH,Hydroelectric Conventional,0,3193496,3193496
1998,NH,Natural Gas,46618,0,46618
1998,NH,Nuclear,0,16774046,16774046
1998,NH,Other Biomass,467610,0,467610
1998,NH,Petroleum,2907708,0,2907708
1998,NH,Total,0,32177706,32177706
1998,NH,Wood and Wood Derived Fuels,1762098,0,1762098
1998,NJ,Coal,15290452,0,15290452
1998,NJ,Hydroelectric Conventional,0,41340,41340
1998,NJ,Natural Gas,32961652,0,32961652
1998,NJ,Nuclear,0,54264278,54264278
1998,NJ,Other,50374,0,50374
1998,NJ,Other Biomass,2621634,0,2621634
1998,NJ,Other Gases,1318256,0,1318256
1998,NJ,Petroleum,1459746,0,1459746
1998,NJ,Pumped Storage,0,-292466,-292466
1998,NJ,Total,0,107715266,107715266
1998,NM,Coal,55074852,0,55074852
1998,NM,Hydroelectric Conventional,0,472824,472824
1998,NM,Natural Gas,9027098,0,9027098
1998,NM,Other Biomass,18412,0,18412
1998,NM,Petroleum,54952,0,54952
1998,NM,Total,0,64648138,64648138
1998,NV,Coal,34322682,0,34322682
1998,NV,Geothermal,3074188,0,3074188
1998,NV,Hydroelectric Conventional,0,6332650,6332650
1998,NV,Natural Gas,17381658,0,17381658
1998,NV,Other,12798,0,12798
1998,NV,Petroleum,103064,0,103064
1998,NV,Total,0,61227040,61227040
1998,NY,Coal,50529560,0,50529560
1998,NY,Hydroelectric Conventional,0,58631556,58631556
1998,NY,Natural Gas,84943198,0,84943198
1998,NY,Nuclear,0,62627416,62627416
1998,NY,Other Biomass,4361092,0,4361092
1998,NY,Other Gases,176626,0,176626
1998,NY,Petroleum,29801564,0,29801564
1998,NY,Pumped Storage,0,-2315362,-2315362
1998,NY,Total,0,289726496,289726496
1998,NY,Wood and Wood Derived Fuels,970846,0,970846
1998,OH,Coal,258446362,0,258446362
1998,OH,Hydroelectric Conventional,0,812854,812854
1998,OH,Natural Gas,1355156,0,1355156
1998,OH,Nuclear,0,32951464,32951464
1998,OH,Other Biomass,482,0,482
1998,OH,Other Gases,371524,0,371524
1998,OH,Petroleum,741676,0,741676
1998,OH,Total,0,295880114,295880114
1998,OH,Wood and Wood Derived Fuels,1200596,0,1200596
1998,OK,Coal,68448060,0,68448060
1998,OK,Hydroelectric Conventional,0,7017496,7017496
1998,OK,Natural Gas,36602836,0,36602836
1998,OK,Other Biomass,3960,0,3960
1998,OK,Other Gases,99638,0,99638
1998,OK,Petroleum,27784,0,27784
1998,OK,Pumped Storage,0,-177470,-177470
1998,OK,Total,0,112458486,112458486
1998,OK,Wood and Wood Derived Fuels,436182,0,436182
1998,OR,Coal,6749244,0,6749244
1998,OR,Hydroelectric Conventional,0,79804334,79804334
1998,OR,Natural Gas,14500130,0,14500130
1998,OR,Other Biomass,185252,0,185252
1998,OR,Petroleum,67264,0,67264
1998,OR,Total,0,102296968,102296968
1998,OR,Wind,0,39046,39046
1998,OR,Wood and Wood Derived Fuels,951698,0,951698
1998,PA,Coal,232774310,0,232774310
1998,PA,Hydroelectric Conventional,0,4762704,4762704
1998,PA,Natural Gas,7780034,0,7780034
1998,PA,Nuclear,0,122298448,122298448
1998,PA,Other,81544,0,81544
1998,PA,Other Biomass,3787298,0,3787298
1998,PA,Other Gases,1261522,0,1261522
1998,PA,Petroleum,9013458,0,9013458
1998,PA,Pumped Storage,0,-919466,-919466
1998,PA,Total,0,382383036,382383036
1998,PA,Wood and Wood Derived Fuels,1543184,0,1543184
1998,RI,Coal,0,0,0
1998,RI,Hydroelectric Conventional,0,17352,17352
1998,RI,Natural Gas,14952748,0,14952748
1998,RI,Other Biomass,222310,0,222310
1998,RI,Petroleum,156612,0,156612
1998,RI,Total,0,15349022,15349022
1998,SC,Coal,65939398,0,65939398
1998,SC,Hydroelectric Conventional,0,7138834,7138834
1998,SC,Natural Gas,1754930,0,1754930
1998,SC,Nuclear,0,97518894,97518894
1998,SC,Other,8892,0,8892
1998,SC,Other Biomass,124664,0,124664
1998,SC,Other Gases,184,0,184
1998,SC,Petroleum,903326,0,903326
1998,SC,Pumped Storage,0,-1979740,-1979740
1998,SC,Total,0,174493122,174493122
1998,SC,Wood and Wood Derived Fuels,3083740,0,3083740
1998,SD,Coal,6188226,0,6188226
1998,SD,Hydroelectric Conventional,0,11515200,11515200
1998,SD,Natural Gas,421452,0,421452
1998,SD,Petroleum,53102,0,53102
1998,SD,Total,0,18177980,18177980
1998,TN,Coal,113665878,0,113665878
1998,TN,Hydroelectric Conventional,0,21612056,21612056
1998,TN,Natural Gas,1715726,0,1715726
1998,TN,Nuclear,0,56775086,56775086
1998,TN,Other,193712,0,193712
1998,TN,Other Biomass,104586,0,104586
1998,TN,Other Gases,31690,0,31690
1998,TN,Petroleum,1412348,0,1412348
1998,TN,Pumped Storage,0,-1244672,-1244672
1998,TN,Total,0,195456914,195456914
1998,TN,Wood and Wood Derived Fuels,1190504,0,1190504
1998,TX,Coal,270852050,0,270852050
1998,TX,Hydroelectric Conventional,0,2849642,2849642
1998,TX,Natural Gas,344287848,0,344287848
1998,TX,Nuclear,0,77370258,77370258
1998,TX,Other,1106668,0,1106668
1998,TX,Other Biomass,188690,0,188690
1998,TX,Other Gases,8155430,0,8155430
1998,TX,Petroleum,3160184,0,3160184
1998,TX,Solar Thermal and Photovoltaic,0,268,268
1998,TX,Total,0,710640328,710640328
1998,TX,Wind,0,160072,160072
1998,TX,Wood and Wood Derived Fuels,2509218,0,2509218
1998,UT,Coal,67175348,0,67175348
1998,UT,Geothermal,320114,0,320114
1998,UT,Hydroelectric Conventional,0,2629422,2629422
1998,UT,Natural Gas,1056514,0,1056514
1998,UT,Other Gases,569566,0,569566
1998,UT,Petroleum,69896,0,69896
1998,UT,Pumped Storage,0,0,0
1998,UT,Total,0,71820860,71820860
1998,VA,Coal,69751530,0,69751530
1998,VA,Hydroelectric Conventional,0,2566590,2566590
1998,VA,Natural Gas,8473490,0,8473490
1998,VA,Nuclear,0,54468798,54468798
1998,VA,Other Biomass,2122748,0,2122748
1998,VA,Other Gases,116,0,116
1998,VA,Petroleum,5852108,0,5852108
1998,VA,Pumped Storage,0,-1910880,-1910880
1998,VA,Solar Thermal and Photovoltaic,0,0,0
1998,VA,Total,0,144398878,144398878
1998,VA,Wood and Wood Derived Fuels,3074378,0,3074378
1998,VT,Hydroelectric Conventional,0,2388098,2388098
1998,VT,Natural Gas,1654,0,1654
1998,VT,Nuclear,0,6715392,6715392
1998,VT,Petroleum,84590,0,84590
1998,VT,Total,0,9892594,9892594
1998,VT,Wind,0,0,0
1998,VT,Wood and Wood Derived Fuels,702860,0,702860
1998,WA,Coal,18624410,0,18624410
1998,WA,Hydroelectric Conventional,0,159629304,159629304
1998,WA,Natural Gas,8692698,0,8692698
1998,WA,Nuclear,0,13832130,13832130
1998,WA,Other,3082,0,3082
1998,WA,Other Biomass,422922,0,422922
1998,WA,Other Gases,697762,0,697762
1998,WA,Petroleum,174086,0,174086
1998,WA,Pumped Storage,0,0,0
1998,WA,Total,0,204317016,204317016
1998,WA,Wood and Wood Derived Fuels,2240622,0,2240622
1998,WI,Coal,82047986,0,82047986
1998,WI,Hydroelectric Conventional,0,3494848,3494848
1998,WI,Natural Gas,4968550,0,4968550
1998,WI,Nuclear,0,18794348,18794348
1998,WI,Other Biomass,739236,0,739236
1998,WI,Petroleum,982990,0,982990
1998,WI,Total,0,112894862,112894862
1998,WI,Wood and Wood Derived Fuels,1866904,0,1866904
1998,WV,Coal,182426710,0,182426710
1998,WV,Hydroelectric Conventional,0,2172688,2172688
1998,WV,Natural Gas,368946,0,368946
1998,WV,Other,430,0,430
1998,WV,Other Gases,273708,0,273708
1998,WV,Petroleum,401890,0,401890
1998,WV,Total,0,185644372,185644372
1998,WY,Coal,87008126,0,87008126
1998,WY,Hydroelectric Conventional,0,2684644,2684644
1998,WY,Natural Gas,736828,0,736828
1998,WY,Other,154632,0,154632
1998,WY,Other Gases,15010,0,15010
1998,WY,Petroleum,91262,0,91262
1998,WY,Total,0,90694592,90694592
1998,WY,Wind,0,4090,4090
1999,AK,Coal,1046738,0,1046738
1999,AK,Hydroelectric Conventional,0,1633216,1633216
1999,AK,Natural Gas,7176150,0,7176150
1999,AK,Petroleum,1748512,0,1748512
1999,AK,Total,0,11604616,11604616
1999,AK,Wind,0,0,0
1999,AL,Coal,147509454,0,147509454
1999,AL,Hydroelectric Conventional,0,15519204,15519204
1999,AL,Natural Gas,6697090,0,6697090
1999,AL,Nuclear,0,61784788,61784788
1999,AL,Other,1654,0,1654
1999,AL,Other Biomass,28660,0,28660
1999,AL,Other Gases,576302,0,576302
1999,AL,Petroleum,632626,0,632626
1999,AL,Total,0,241315016,241315016
1999,AL,Wood and Wood Derived Fuels,8565238,0,8565238
1999,AR,Coal,49337614,0,49337614
1999,AR,Hydroelectric Conventional,0,5388668,5388668
1999,AR,Natural Gas,9085192,0,9085192
1999,AR,Nuclear,0,25839100,25839100
1999,AR,Other,5562,0,5562
1999,AR,Other Biomass,10454,0,10454
1999,AR,Other Gases,294,0,294
1999,AR,Petroleum,319930,0,319930
1999,AR,Pumped Storage,0,0,0
1999,AR,Total,0,93107878,93107878
1999,AR,Wood and Wood Derived Fuels,3121064,0,3121064
1999,AZ,Coal,76610330,0,76610330
1999,AZ,Hydroelectric Conventional,0,19517634,19517634
1999,AZ,Natural Gas,10068890,0,10068890
1999,AZ,Nuclear,0,60831144,60831144
1999,AZ,Other Biomass,9568,0,9568
1999,AZ,Petroleum,100710,0,100710
1999,AZ,Pumped Storage,0,648070,648070
1999,AZ,Solar Thermal and Photovoltaic,0,0,0
1999,AZ,Total,0,167786346,167786346
1999,CA,Coal,4592164,0,4592164
1999,CA,Geothermal,26091430,0,26091430
1999,CA,Hydroelectric Conventional,0,81473334,81473334
1999,CA,Natural Gas,170197724,0,170197724
1999,CA,Nuclear,0,66743714,66743714
1999,CA,Other,46854,0,46854
1999,CA,Other Biomass,4765292,0,4765292
1999,CA,Other Gases,4835226,0,4835226
1999,CA,Petroleum,4275832,0,4275832
1999,CA,Pumped Storage,0,-772428,-772428
1999,CA,Solar Thermal and Photovoltaic,0,989992,989992
1999,CA,Total,0,376638446,376638446
1999,CA,Wind,0,6459906,6459906
1999,CA,Wood and Wood Derived Fuels,6939406,0,6939406
1999,CO,Coal,65754128,0,65754128
1999,CO,Hydroelectric Conventional,0,3124970,3124970
1999,CO,Natural Gas,9934766,0,9934766
1999,CO,Other Biomass,63544,0,63544
1999,CO,Petroleum,92470,0,92470
1999,CO,Pumped Storage,0,72698,72698
1999,CO,Total,0,79042576,79042576
1999,CT,Coal,2972134,0,2972134
1999,CT,Hydroelectric Conventional,0,843924,843924
1999,CT,Natural Gas,7203186,0,7203186
1999,CT,Nuclear,0,25350524,25350524
1999,CT,Other,0,0,0
1999,CT,Other Biomass,4211954,0,4211954
1999,CT,Other Gases,69662,0,69662
1999,CT,Petroleum,16536630,0,16536630
1999,CT,Pumped Storage,0,5782,5782
1999,CT,Total,0,57193796,57193796
1999,DC,Petroleum,460006,0,460006
1999,DC,Total,0,460006,460006
1999,DE,Coal,5669422,0,5669422
1999,DE,Natural Gas,4485582,0,4485582
1999,DE,Other Gases,339370,0,339370
1999,DE,Petroleum,3209102,0,3209102
1999,DE,Total,0,13703476,13703476
1999,FL,Coal,135259854,0,135259854
1999,FL,Hydroelectric Conventional,0,280350,280350
1999,FL,Natural Gas,86333912,0,86333912
1999,FL,Nuclear,0,63052570,63052570
1999,FL,Other,4076152,0,4076152
1999,FL,Other Biomass,7070794,0,7070794
1999,FL,Other Gases,53238,0,53238
1999,FL,Petroleum,74261260,0,74261260
1999,FL,Total,0,374526852,374526852
1999,FL,Wood and Wood Derived Fuels,4138722,0,4138722
1999,GA,Coal,150289318,0,150289318
1999,GA,Hydroelectric Conventional,0,5502348,5502348
1999,GA,Natural Gas,6457538,0,6457538
1999,GA,Nuclear,0,62956244,62956244
1999,GA,Other,18138,0,18138
1999,GA,Other Biomass,94224,0,94224
1999,GA,Petroleum,3124934,0,3124934
1999,GA,Pumped Storage,0,-96172,-96172
1999,GA,Total,0,234677490,234677490
1999,GA,Wood and Wood Derived Fuels,6330918,0,6330918
1999,HI,Coal,2880490,0,2880490
1999,HI,Geothermal,421714,0,421714
1999,HI,Hydroelectric Conventional,0,229804,229804
1999,HI,Other Biomass,1153190,0,1153190
1999,HI,Other Gases,99022,0,99022
1999,HI,Petroleum,15990644,0,15990644
1999,HI,Total,0,20807852,20807852
1999,HI,Wind,0,32988,32988
1999,IA,Coal,66308472,0,66308472
1999,IA,Hydroelectric Conventional,0,1891244,1891244
1999,IA,Natural Gas,1014750,0,1014750
1999,IA,Nuclear,0,7280516,7280516
1999,IA,Other Biomass,181154,0,181154
1999,IA,Petroleum,272906,0,272906
1999,IA,Total,0,77602962,77602962
1999,IA,Wind,0,652708,652708
1999,IA,Wood and Wood Derived Fuels,1212,0,1212
1999,ID,Coal,103774,0,103774
1999,ID,Hydroelectric Conventional,0,26998302,26998302
1999,ID,Natural Gas,663220,0,663220
1999,ID,Other,162142,0,162142
1999,ID,Petroleum,488,0,488
1999,ID,Total,0,28873296,28873296
1999,ID,Wood and Wood Derived Fuels,945370,0,945370
1999,IL,Coal,150179054,0,150179054
1999,IL,Hydroelectric Conventional,0,284188,284188
1999,IL,Natural Gas,9993056,0,9993056
1999,IL,Nuclear,0,163487778,163487778
1999,IL,Other,41766,0,41766
1999,IL,Other Biomass,1391168,0,1391168
1999,IL,Other Gases,642526,0,642526
1999,IL,Petroleum,800972,0,800972
1999,IL,Total,0,326821040,326821040
1999,IL,Wood and Wood Derived Fuels,532,0,532
1999,IN,Coal,230418410,0,230418410
1999,IN,Hydroelectric Conventional,0,813948,813948
1999,IN,Natural Gas,4218242,0,4218242
1999,IN,Other,47752,0,47752
1999,IN,Other Biomass,251956,0,251956
1999,IN,Other Gases,5937780,0,5937780
1999,IN,Petroleum,1840914,0,1840914
1999,IN,Total,0,243529002,243529002
1999,KS,Coal,59298200,0,59298200
1999,KS,Hydroelectric Conventional,0,24734,24734
1999,KS,Natural Gas,5881598,0,5881598
1999,KS,Nuclear,0,18313238,18313238
1999,KS,Petroleum,622690,0,622690
1999,KS,Total,0,84140460,84140460
1999,KY,Coal,179045866,0,179045866
1999,KY,Hydroelectric Conventional,0,5113144,5113144
1999,KY,Natural Gas,925020,0,925020
1999,KY,Petroleum,254968,0,254968
1999,KY,Total,0,185363816,185363816
1999,KY,Wood and Wood Derived Fuels,24818,0,24818
1999,LA,Coal,42364208,0,42364208
1999,LA,Hydroelectric Conventional,0,1603652,1603652
1999,LA,Natural Gas,95997438,0,95997438
1999,LA,Nuclear,0,26223208,26223208
1999,LA,Other,806908,0,806908
1999,LA,Other Biomass,251436,0,251436
1999,LA,Other Gases,3302538,0,3302538
1999,LA,Petroleum,3864922,0,3864922
1999,LA,Total,0,179883506,179883506
1999,LA,Wood and Wood Derived Fuels,5469196,0,5469196
1999,MA,Coal,22339694,0,22339694
1999,MA,Hydroelectric Conventional,0,1949136,1949136
1999,MA,Natural Gas,22208798,0,22208798
1999,MA,Nuclear,0,9036852,9036852
1999,MA,Other Biomass,3876240,0,3876240
1999,MA,Petroleum,22483900,0,22483900
1999,MA,Pumped Storage,0,-938734,-938734
1999,MA,Total,0,81150784,81150784
1999,MA,Wind,0,0,0
1999,MA,Wood and Wood Derived Fuels,194898,0,194898
1999,MD,Coal,59375310,0,59375310
1999,MD,Hydroelectric Conventional,0,2848394,2848394
1999,MD,Natural Gas,4250386,0,4250386
1999,MD,Nuclear,0,26624670,26624670
1999,MD,Other Biomass,1228948,0,1228948
1999,MD,Other Gases,119782,0,119782
1999,MD,Petroleum,8581576,0,8581576
1999,MD,Total,0,103371242,103371242
1999,MD,Wood and Wood Derived Fuels,342176,0,342176
1999,ME,Coal,988814,0,988814
1999,ME,Hydroelectric Conventional,0,7511912,7511912
1999,ME,Natural Gas,161470,0,161470
1999,ME,Other Biomass,1055520,0,1055520
1999,ME,Other Gases,9034,0,9034
1999,ME,Petroleum,9422842,0,9422842
1999,ME,Total,0,25347858,25347858
1999,ME,Wood and Wood Derived Fuels,6198266,0,6198266
1999,MI,Coal,140809988,0,140809988
1999,MI,Hydroelectric Conventional,0,2916666,2916666
1999,MI,Natural Gas,27027510,0,27027510
1999,MI,Nuclear,0,29181422,29181422
1999,MI,Other,34,0,34
1999,MI,Other Biomass,1958762,0,1958762
1999,MI,Other Gases,306,0,306
1999,MI,Petroleum,2968708,0,2968708
1999,MI,Pumped Storage,0,-1864948,-1864948
1999,MI,Total,0,206479430,206479430
1999,MI,Wind,0,0,0
1999,MI,Wood and Wood Derived Fuels,3480982,0,3480982
1999,MN,Coal,60376250,0,60376250
1999,MN,Hydroelectric Conventional,0,2357866,2357866
1999,MN,Natural Gas,2854544,0,2854544
1999,MN,Nuclear,0,26631124,26631124
1999,MN,Other Biomass,1461242,0,1461242
1999,MN,Petroleum,1400294,0,1400294
1999,MN,Total,0,97038758,97038758
1999,MN,Wind,0,971384,971384
1999,MN,Wood and Wood Derived Fuels,986054,0,986054
1999,MO,Coal,123014596,0,123014596
1999,MO,Hydroelectric Conventional,0,3706130,3706130
1999,MO,Natural Gas,3253616,0,3253616
1999,MO,Nuclear,0,17173292,17173292
1999,MO,Other Biomass,122934,0,122934
1999,MO,Petroleum,586344,0,586344
1999,MO,Pumped Storage,0,-225492,-225492
1999,MO,Total,0,147631420,147631420
1999,MS,Coal,26084586,0,26084586
1999,MS,Natural Gas,17584886,0,17584886
1999,MS,Nuclear,0,16856432,16856432
1999,MS,Petroleum,6290106,0,6290106
1999,MS,Total,0,69689944,69689944
1999,MS,Wood and Wood Derived Fuels,2873934,0,2873934
1999,MT,Coal,33986310,0,33986310
1999,MT,Hydroelectric Conventional,0,27644124,27644124
1999,MT,Natural Gas,73212,0,73212
1999,MT,Other Gases,61212,0,61212
1999,MT,Petroleum,973918,0,973918
1999,MT,Total,0,62838668,62838668
1999,MT,Wood and Wood Derived Fuels,99892,0,99892
1999,NC,Coal,144511012,0,144511012
1999,NC,Hydroelectric Conventional,0,7368372,7368372
1999,NC,Natural Gas,2333326,0,2333326
1999,NC,Nuclear,0,75047008,75047008
1999,NC,Other,505568,0,505568
1999,NC,Other Biomass,185308,0,185308
1999,NC,Petroleum,1324140,0,1324140
1999,NC,Pumped Storage,0,350794,350794
1999,NC,Total,0,234715230,234715230
1999,NC,Wood and Wood Derived Fuels,3089702,0,3089702
1999,ND,Coal,57386068,0,57386068
1999,ND,Hydroelectric Conventional,0,5218318,5218318
1999,ND,Natural Gas,3208,0,3208
1999,ND,Other Biomass,11128,0,11128
1999,ND,Other Gases,106242,0,106242
1999,ND,Petroleum,109842,0,109842
1999,ND,Total,0,62834806,62834806
1999,NE,Coal,35674352,0,35674352
1999,NE,Hydroelectric Conventional,0,3438060,3438060
1999,NE,Natural Gas,725256,0,725256
1999,NE,Nuclear,0,20182184,20182184
1999,NE,Other Biomass,32404,0,32404
1999,NE,Petroleum,59246,0,59246
1999,NE,Total,0,60111502,60111502
1999,NE,Wind,0,0,0
1999,NH,Coal,6656526,0,6656526
1999,NH,Hydroelectric Conventional,0,2822564,2822564
1999,NH,Natural Gas,148910,0,148910
1999,NH,Nuclear,0,17352474,17352474
1999,NH,Other Biomass,481534,0,481534
1999,NH,Petroleum,3144026,0,3144026
1999,NH,Total,0,32378494,32378494
1999,NH,Wood and Wood Derived Fuels,1772460,0,1772460
1999,NJ,Coal,16128784,0,16128784
1999,NJ,Hydroelectric Conventional,0,34606,34606
1999,NJ,Natural Gas,34198472,0,34198472
1999,NJ,Nuclear,0,57941786,57941786
1999,NJ,Other,55280,0,55280
1999,NJ,Other Biomass,2730502,0,2730502
1999,NJ,Other Gases,1223298,0,1223298
1999,NJ,Petroleum,1584940,0,1584940
1999,NJ,Pumped Storage,0,-290826,-290826
1999,NJ,Total,0,113606842,113606842
1999,NM,Coal,56135408,0,56135408
1999,NM,Hydroelectric Conventional,0,485420,485420
1999,NM,Natural Gas,8313096,0,8313096
1999,NM,Other Biomass,22026,0,22026
1999,NM,Petroleum,87762,0,87762
1999,NM,Total,0,65043712,65043712
1999,NV,Coal,33815060,0,33815060
1999,NV,Geothermal,2829824,0,2829824
1999,NV,Hydroelectric Conventional,0,5655342,5655342
1999,NV,Natural Gas,18693082,0,18693082
1999,NV,Petroleum,70954,0,70954
1999,NV,Total,0,61064262,61064262
1999,NY,Coal,46731884,0,46731884
1999,NY,Hydroelectric Conventional,0,49504636,49504636
1999,NY,Natural Gas,91998376,0,91998376
1999,NY,Nuclear,0,74037080,74037080
1999,NY,Other Biomass,4515456,0,4515456
1999,NY,Other Gases,223908,0,223908
1999,NY,Petroleum,26608384,0,26608384
1999,NY,Pumped Storage,0,-2218150,-2218150
1999,NY,Total,0,292561732,292561732
1999,NY,Wood and Wood Derived Fuels,1160158,0,1160158
1999,OH,Coal,246640282,0,246640282
1999,OH,Hydroelectric Conventional,0,846062,846062
1999,OH,Natural Gas,1772892,0,1772892
1999,OH,Nuclear,0,32844020,32844020
1999,OH,Other Biomass,0,0,0
1999,OH,Other Gases,312848,0,312848
1999,OH,Petroleum,967996,0,967996
1999,OH,Total,0,284660862,284660862
1999,OH,Wood and Wood Derived Fuels,1276762,0,1276762
1999,OK,Coal,67420022,0,67420022
1999,OK,Hydroelectric Conventional,0,6350798,6350798
1999,OK,Natural Gas,35704612,0,35704612
1999,OK,Other Biomass,3206,0,3206
1999,OK,Other Gases,110530,0,110530
1999,OK,Petroleum,33250,0,33250
1999,OK,Pumped Storage,0,-212748,-212748
1999,OK,Total,0,109730718,109730718
1999,OK,Wood and Wood Derived Fuels,321048,0,321048
1999,OR,Coal,7445288,0,7445288
1999,OR,Hydroelectric Conventional,0,91278100,91278100
1999,OR,Natural Gas,13760880,0,13760880
1999,OR,Other Biomass,184820,0,184820
1999,OR,Petroleum,16058,0,16058
1999,OR,Total,0,113696694,113696694
1999,OR,Wind,0,169584,169584
1999,OR,Wood and Wood Derived Fuels,841964,0,841964
1999,PA,Coal,222428748,0,222428748
1999,PA,Hydroelectric Conventional,0,3893196,3893196
1999,PA,Natural Gas,7604026,0,7604026
1999,PA,Nuclear,0,142254898,142254898
1999,PA,Other,115314,0,115314
1999,PA,Other Biomass,4076752,0,4076752
1999,PA,Other Gases,1150586,0,1150586
1999,PA,Petroleum,6992476,0,6992476
1999,PA,Pumped Storage,0,-899224,-899224
1999,PA,Total,0,389056090,389056090
1999,PA,Wood and Wood Derived Fuels,1439318,0,1439318
1999,RI,Hydroelectric Conventional,0,12100,12100
1999,RI,Natural Gas,12369200,0,12369200
1999,RI,Other Biomass,228384,0,228384
1999,RI,Petroleum,144078,0,144078
1999,RI,Total,0,12753762,12753762
1999,SC,Coal,71609886,0,71609886
1999,SC,Hydroelectric Conventional,0,3374702,3374702
1999,SC,Natural Gas,2093100,0,2093100
1999,SC,Nuclear,0,101627118,101627118
1999,SC,Other Biomass,121154,0,121154
1999,SC,Other Gases,109218,0,109218
1999,SC,Petroleum,773130,0,773130
1999,SC,Pumped Storage,0,-1993554,-1993554
1999,SC,Total,0,180467016,180467016
1999,SC,Wood and Wood Derived Fuels,2752262,0,2752262
1999,SD,Coal,7348800,0,7348800
1999,SD,Hydroelectric Conventional,0,13354606,13354606
1999,SD,Natural Gas,362410,0,362410
1999,SD,Petroleum,48238,0,48238
1999,SD,Total,0,21114054,21114054
1999,TN,Coal,113756076,0,113756076
1999,TN,Hydroelectric Conventional,0,15603914,15603914
1999,TN,Natural Gas,1386412,0,1386412
1999,TN,Nuclear,0,54454450,54454450
1999,TN,Other,225664,0,225664
1999,TN,Other Biomass,77496,0,77496
1999,TN,Other Gases,28902,0,28902
1999,TN,Petroleum,1031150,0,1031150
1999,TN,Pumped Storage,0,-1303352,-1303352
1999,TN,Total,0,186640274,186640274
1999,TN,Wood and Wood Derived Fuels,1379562,0,1379562
1999,TX,Coal,281729798,0,281729798
1999,TX,Hydroelectric Conventional,0,2240412,2240412
1999,TX,Natural Gas,344121546,0,344121546
1999,TX,Nuclear,0,73519798,73519798
1999,TX,Other,1790152,0,1790152
1999,TX,Other Biomass,148930,0,148930
1999,TX,Other Gases,7943850,0,7943850
1999,TX,Petroleum,3501838,0,3501838
1999,TX,Solar Thermal and Photovoltaic,0,172,172
1999,TX,Total,0,717889488,717889488
1999,TX,Wind,0,639920,639920
1999,TX,Wood and Wood Derived Fuels,2253072,0,2253072
1999,UT,Coal,69067562,0,69067562
1999,UT,Geothermal,311060,0,311060
1999,UT,Hydroelectric Conventional,0,2510284,2510284
1999,UT,Natural Gas,1220114,0,1220114
1999,UT,Other Biomass,16338,0,16338
1999,UT,Other Gases,382570,0,382570
1999,UT,Petroleum,61328,0,61328
1999,UT,Pumped Storage,0,0,0
1999,UT,Total,0,73569256,73569256
1999,VA,Coal,70889046,0,70889046
1999,VA,Hydroelectric Conventional,0,1363374,1363374
1999,VA,Natural Gas,9278962,0,9278962
1999,VA,Nuclear,0,56601286,56601286
1999,VA,Other Biomass,2146876,0,2146876
1999,VA,Petroleum,6725476,0,6725476
1999,VA,Pumped Storage,0,-2455514,-2455514
1999,VA,Solar Thermal and Photovoltaic,0,0,0
1999,VA,Total,0,147795222,147795222
1999,VA,Wood and Wood Derived Fuels,3245716,0,3245716
1999,VT,Hydroelectric Conventional,0,2391392,2391392
1999,VT,Natural Gas,36582,0,36582
1999,VT,Nuclear,0,8118214,8118214
1999,VT,Petroleum,49956,0,49956
1999,VT,Total,0,11407186,11407186
1999,VT,Wind,0,27208,27208
1999,VT,Wood and Wood Derived Fuels,783834,0,783834
1999,WA,Coal,17384958,0,17384958
1999,WA,Hydroelectric Conventional,0,193978764,193978764
1999,WA,Natural Gas,7414474,0,7414474
1999,WA,Nuclear,0,12171786,12171786
1999,WA,Other,88,0,88
1999,WA,Other Biomass,413646,0,413646
1999,WA,Other Gases,442708,0,442708
1999,WA,Petroleum,102990,0,102990
1999,WA,Pumped Storage,0,0,0
1999,WA,Total,0,234168036,234168036
1999,WA,Wood and Wood Derived Fuels,2258622,0,2258622
1999,WI,Coal,82263108,0,82263108
1999,WI,Hydroelectric Conventional,0,3969188,3969188
1999,WI,Natural Gas,4417360,0,4417360
1999,WI,Nuclear,0,22989528,22989528
1999,WI,Other Biomass,561368,0,561368
1999,WI,Petroleum,1082844,0,1082844
1999,WI,Total,0,117077708,117077708
1999,WI,Wind,0,0,0
1999,WI,Wood and Wood Derived Fuels,1794312,0,1794312
1999,WV,Coal,186658452,0,186658452
1999,WV,Hydroelectric Conventional,0,1860510,1860510
1999,WV,Natural Gas,328944,0,328944
1999,WV,Other,390,0,390
1999,WV,Other Gases,150916,0,150916
1999,WV,Petroleum,385980,0,385980
1999,WV,Total,0,189385192,189385192
1999,WY,Coal,83878144,0,83878144
1999,WY,Hydroelectric Conventional,0,2340450,2340450
1999,WY,Natural Gas,759248,0,759248
1999,WY,Other,148130,0,148130
1999,WY,Other Gases,19312,0,19312
1999,WY,Petroleum,97398,0,97398
1999,WY,Total,0,87264982,87264982
1999,WY,Wind,0,22300,22300
2000,AK,Coal,1077346,0,1077346
2000,AK,Hydroelectric Conventional,0,2003638,2003638
2000,AK,Natural Gas,7951664,0,7951664
2000,AK,Petroleum,1280402,0,1280402
2000,AK,Total,0,12313050,12313050
2000,AK,Wind,0,0,0
2000,AL,Coal,155035428,0,155035428
2000,AL,Hydroelectric Conventional,0,11635262,11635262
2000,AL,Natural Gas,10056422,0,10056422
2000,AL,Nuclear,0,62737126,62737126
2000,AL,Other,1516,0,1516
2000,AL,Other Biomass,58024,0,58024
2000,AL,Other Gases,460286,0,460286
2000,AL,Petroleum,732310,0,732310
2000,AL,Total,0,248810680,248810680
2000,AL,Wood and Wood Derived Fuels,8094306,0,8094306
2000,AR,Coal,48335398,0,48335398
2000,AR,Hydroelectric Conventional,0,4740966,4740966
2000,AR,Natural Gas,7725018,0,7725018
2000,AR,Nuclear,0,23303544,23303544
2000,AR,Other,15078,0,15078
2000,AR,Other Biomass,14910,0,14910
2000,AR,Petroleum,443456,0,443456
2000,AR,Pumped Storage,0,0,0
2000,AR,Total,0,87751532,87751532
2000,AR,Wood and Wood Derived Fuels,3173162,0,3173162
2000,AZ,Coal,81986258,0,81986258
2000,AZ,Hydroelectric Conventional,0,16708432,16708432
2000,AZ,Natural Gas,17469598,0,17469598
2000,AZ,Nuclear,0,60761142,60761142
2000,AZ,Other Biomass,9166,0,9166
2000,AZ,Petroleum,380646,0,380646
2000,AZ,Pumped Storage,0,577912,577912
2000,AZ,Solar Thermal and Photovoltaic,0,0,0
2000,AZ,Total,0,177893154,177893154
2000,CA,Coal,4727214,0,4727214
2000,CA,Geothermal,24616942,0,24616942
2000,CA,Hydroelectric Conventional,0,76667572,76667572
2000,CA,Natural Gas,206437946,0,206437946
2000,CA,Nuclear,0,70351010,70351010
2000,CA,Other,44080,0,44080
2000,CA,Other Biomass,5220664,0,5220664
2000,CA,Other Gases,5374354,0,5374354
2000,CA,Petroleum,5679588,0,5679588
2000,CA,Pumped Storage,0,1875880,1875880
2000,CA,Solar Thermal and Photovoltaic,0,986668,986668
2000,CA,Total,0,416164966,416164966
2000,CA,Wind,0,7036046,7036046
2000,CA,Wood and Wood Derived Fuels,7147002,0,7147002
2000,CO,Coal,70762438,0,70762438
2000,CO,Hydroelectric Conventional,0,2908830,2908830
2000,CO,Natural Gas,14314876,0,14314876
2000,CO,Other Biomass,35828,0,35828
2000,CO,Petroleum,218770,0,218770
2000,CO,Pumped Storage,0,90350,90350
2000,CO,Total,0,88331092,88331092
2000,CO,Wind,0,0,0
2000,CT,Coal,6372192,0,6372192
2000,CT,Hydroelectric Conventional,0,1052624,1052624
2000,CT,Natural Gas,8124058,0,8124058
2000,CT,Nuclear,0,32730668,32730668
2000,CT,Other Biomass,4306270,0,4306270
2000,CT,Petroleum,13358064,0,13358064
2000,CT,Pumped Storage,0,-8736,-8736
2000,CT,Total,0,65935140,65935140
2000,DC,Petroleum,288748,0,288748
2000,DC,Total,0,288748,288748
2000,DE,Coal,8224592,0,8224592
2000,DE,Natural Gas,1681016,0,1681016
2000,DE,Other Biomass,37676,0,37676
2000,DE,Other Gases,333538,0,333538
2000,DE,Petroleum,1698080,0,1698080
2000,DE,Total,0,11974902,11974902
2000,FL,Coal,145483658,0,145483658
2000,FL,Hydroelectric Conventional,0,173538,173538
2000,FL,Natural Gas,86405734,0,86405734
2000,FL,Nuclear,0,64582690,64582690
2000,FL,Other,4072366,0,4072366
2000,FL,Other Biomass,7262626,0,7262626
2000,FL,Other Gases,46942,0,46942
2000,FL,Petroleum,71486060,0,71486060
2000,FL,Total,0,383631680,383631680
2000,FL,Wood and Wood Derived Fuels,4118066,0,4118066
2000,GA,Coal,160200900,0,160200900
2000,GA,Hydroelectric Conventional,0,4961594,4961594
2000,GA,Natural Gas,8502154,0,8502154
2000,GA,Nuclear,0,64945870,64945870
2000,GA,Other,3060,0,3060
2000,GA,Other Biomass,178680,0,178680
2000,GA,Petroleum,3241306,0,3241306
2000,GA,Pumped Storage,0,-309656,-309656
2000,GA,Total,0,247754826,247754826
2000,GA,Wood and Wood Derived Fuels,6030918,0,6030918
2000,HI,Coal,3157170,0,3157170
2000,HI,Geothermal,524106,0,524106
2000,HI,Hydroelectric Conventional,0,206916,206916
2000,HI,Natural Gas,0,0,0
2000,HI,Other Biomass,1076698,0,1076698
2000,HI,Other Gases,84346,0,84346
2000,HI,Petroleum,16103564,0,16103564
2000,HI,Total,0,21186806,21186806
2000,HI,Wind,0,34006,34006
2000,IA,Coal,70134186,0,70134186
2000,IA,Hydroelectric Conventional,0,1808020,1808020
2000,IA,Natural Gas,867528,0,867528
2000,IA,Nuclear,0,8905768,8905768
2000,IA,Other Biomass,177124,0,177124
2000,IA,Petroleum,203754,0,203754
2000,IA,Total,0,83084020,83084020
2000,IA,Wind,0,987640,987640
2000,ID,Coal,141350,0,141350
2000,ID,Hydroelectric Conventional,0,21933390,21933390
2000,ID,Natural Gas,598106,0,598106
2000,ID,Other,167626,0,167626
2000,ID,Petroleum,13896,0,13896
2000,ID,Total,0,23820884,23820884
2000,ID,Wood and Wood Derived Fuels,966516,0,966516
2000,IL,Coal,164645664,0,164645664
2000,IL,Hydroelectric Conventional,0,287656,287656
2000,IL,Natural Gas,9331126,0,9331126
2000,IL,Nuclear,0,178876098,178876098
2000,IL,Other Biomass,1816782,0,1816782
2000,IL,Other Gases,768796,0,768796
2000,IL,Petroleum,1266040,0,1266040
2000,IL,Total,0,356992162,356992162
2000,IN,Coal,242955768,0,242955768
2000,IN,Hydroelectric Conventional,0,1176552,1176552
2000,IN,Natural Gas,4109232,0,4109232
2000,IN,Other Biomass,259764,0,259764
2000,IN,Other Gases,5198674,0,5198674
2000,IN,Petroleum,1939042,0,1939042
2000,IN,Total,0,255639032,255639032
2000,KS,Coal,65014102,0,65014102
2000,KS,Hydroelectric Conventional,0,30664,30664
2000,KS,Natural Gas,5622632,0,5622632
2000,KS,Nuclear,0,18121668,18121668
2000,KS,Petroleum,842744,0,842744
2000,KS,Total,0,89631810,89631810
2000,KY,Coal,180126108,0,180126108
2000,KY,Hydroelectric Conventional,0,4649136,4649136
2000,KY,Natural Gas,922730,0,922730
2000,KY,Other Gases,220,0,220
2000,KY,Petroleum,289386,0,289386
2000,KY,Total,0,186012166,186012166
2000,KY,Wood and Wood Derived Fuels,24586,0,24586
2000,LA,Coal,46977728,0,46977728
2000,LA,Hydroelectric Conventional,0,1064580,1064580
2000,LA,Natural Gas,92258486,0,92258486
2000,LA,Nuclear,0,31591478,31591478
2000,LA,Other,904110,0,904110
2000,LA,Other Biomass,189766,0,189766
2000,LA,Other Gases,3197264,0,3197264
2000,LA,Petroleum,4152720,0,4152720
2000,LA,Total,0,185731270,185731270
2000,LA,Wood and Wood Derived Fuels,5395138,0,5395138
2000,MA,Coal,22308544,0,22308544
2000,MA,Hydroelectric Conventional,0,2130318,2130318
2000,MA,Natural Gas,21414144,0,21414144
2000,MA,Nuclear,0,11024510,11024510
2000,MA,Other Biomass,4149422,0,4149422
2000,MA,Petroleum,17525338,0,17525338
2000,MA,Pumped Storage,0,-1400728,-1400728
2000,MA,Total,0,77395762,77395762
2000,MA,Wind,0,0,0
2000,MA,Wood and Wood Derived Fuels,244214,0,244214
2000,MD,Coal,58902130,0,58902130
2000,MD,Hydroelectric Conventional,0,3465238,3465238
2000,MD,Natural Gas,5705752,0,5705752
2000,MD,Nuclear,0,27654486,27654486
2000,MD,Other Biomass,1277660,0,1277660
2000,MD,Other Gases,149144,0,149144
2000,MD,Petroleum,4777190,0,4777190
2000,MD,Total,0,102290760,102290760
2000,MD,Wood and Wood Derived Fuels,359160,0,359160
2000,ME,Coal,1299496,0,1299496
2000,ME,Hydroelectric Conventional,0,7181630,7181630
2000,ME,Natural Gas,6088880,0,6088880
2000,ME,Other,287494,0,287494
2000,ME,Other Biomass,1161740,0,1161740
2000,ME,Petroleum,5594658,0,5594658
2000,ME,Total,0,28095894,28095894
2000,ME,Wood and Wood Derived Fuels,6481996,0,6481996
2000,MI,Coal,136533998,0,136533998
2000,MI,Hydroelectric Conventional,0,2855358,2855358
2000,MI,Natural Gas,25214528,0,25214528
2000,MI,Nuclear,0,37764864,37764864
2000,MI,Other,122,0,122
2000,MI,Other Biomass,2197570,0,2197570
2000,MI,Petroleum,2378526,0,2378526
2000,MI,Pumped Storage,0,-2107396,-2107396
2000,MI,Total,0,208419188,208419188
2000,MI,Wind,0,0,0
2000,MI,Wood and Wood Derived Fuels,3581618,0,3581618
2000,MN,Coal,67496176,0,67496176
2000,MN,Hydroelectric Conventional,0,1862766,1862766
2000,MN,Natural Gas,2530042,0,2530042
2000,MN,Nuclear,0,25919952,25919952
2000,MN,Other Biomass,1594444,0,1594444
2000,MN,Petroleum,949554,0,949554
2000,MN,Total,0,102846678,102846678
2000,MN,Wind,0,1449048,1449048
2000,MN,Wood and Wood Derived Fuels,1044696,0,1044696
2000,MO,Coal,125807114,0,125807114
2000,MO,Hydroelectric Conventional,0,1199840,1199840
2000,MO,Natural Gas,5910282,0,5910282
2000,MO,Nuclear,0,19983690,19983690
2000,MO,Other Biomass,165706,0,165706
2000,MO,Petroleum,505436,0,505436
2000,MO,Pumped Storage,0,-384190,-384190
2000,MO,Total,0,153187878,153187878
2000,MS,Coal,27754130,0,27754130
2000,MS,Natural Gas,16762218,0,16762218
2000,MS,Nuclear,0,21389110,21389110
2000,MS,Other Biomass,436,0,436
2000,MS,Petroleum,5963060,0,5963060
2000,MS,Total,0,75229126,75229126
2000,MS,Wood and Wood Derived Fuels,3360172,0,3360172
2000,MT,Coal,32401678,0,32401678
2000,MT,Hydroelectric Conventional,0,19246514,19246514
2000,MT,Natural Gas,53214,0,53214
2000,MT,Other Gases,68622,0,68622
2000,MT,Petroleum,1039782,0,1039782
2000,MT,Total,0,52903656,52903656
2000,MT,Wood and Wood Derived Fuels,93846,0,93846
2000,NC,Coal,151890926,0,151890926
2000,NC,Hydroelectric Conventional,0,6275632,6275632
2000,NC,Natural Gas,2260506,0,2260506
2000,NC,Nuclear,0,78253762,78253762
2000,NC,Other,452886,0,452886
2000,NC,Other Biomass,218752,0,218752
2000,NC,Petroleum,1651662,0,1651662
2000,NC,Pumped Storage,0,216204,216204
2000,NC,Total,0,244548712,244548712
2000,NC,Wood and Wood Derived Fuels,3328382,0,3328382
2000,ND,Coal,58138406,0,58138406
2000,ND,Hydroelectric Conventional,0,4245122,4245122
2000,ND,Natural Gas,4174,0,4174
2000,ND,Other Biomass,15950,0,15950
2000,ND,Other Gases,96826,0,96826
2000,ND,Petroleum,121914,0,121914
2000,ND,Total,0,62622392,62622392
2000,NE,Coal,36915866,0,36915866
2000,NE,Hydroelectric Conventional,0,3001448,3001448
2000,NE,Natural Gas,902708,0,902708
2000,NE,Nuclear,0,17257358,17257358
2000,NE,Other Biomass,33028,0,33028
2000,NE,Petroleum,109318,0,109318
2000,NE,Total,0,58219726,58219726
2000,NE,Wind,0,0,0
2000,NH,Coal,7930952,0,7930952
2000,NH,Hydroelectric Conventional,0,2854428,2854428
2000,NH,Natural Gas,277886,0,277886
2000,NH,Nuclear,0,15843760,15843760
2000,NH,Other Biomass,488540,0,488540
2000,NH,Petroleum,942656,0,942656
2000,NH,Total,0,30062998,30062998
2000,NH,Wood and Wood Derived Fuels,1724776,0,1724776
2000,NJ,Coal,20180230,0,20180230
2000,NJ,Hydroelectric Conventional,0,28072,28072
2000,NJ,Natural Gas,33018498,0,33018498
2000,NJ,Nuclear,0,57156238,57156238
2000,NJ,Other Biomass,2728628,0,2728628
2000,NJ,Other Gases,1169468,0,1169468
2000,NJ,Petroleum,2170552,0,2170552
2000,NJ,Pumped Storage,0,-281256,-281256
2000,NJ,Total,0,116170430,116170430
2000,NM,Coal,58131908,0,58131908
2000,NM,Hydroelectric Conventional,0,442304,442304
2000,NM,Natural Gas,9276678,0,9276678
2000,NM,Other Biomass,16928,0,16928
2000,NM,Petroleum,176222,0,176222
2000,NM,Total,0,68044040,68044040
2000,NV,Coal,37863042,0,37863042
2000,NV,Geothermal,2741582,0,2741582
2000,NV,Hydroelectric Conventional,0,4858936,4858936
2000,NV,Natural Gas,25334378,0,25334378
2000,NV,Other,42304,0,42304
2000,NV,Petroleum,129588,0,129588
2000,NV,Total,0,70969830,70969830
2000,NY,Coal,50019162,0,50019162
2000,NY,Hydroelectric Conventional,0,49819144,49819144
2000,NY,Natural Gas,79457418,0,79457418
2000,NY,Nuclear,0,63015976,63015976
2000,NY,Other Biomass,4463224,0,4463224
2000,NY,Other Gases,172402,0,172402
2000,NY,Petroleum,29890358,0,29890358
2000,NY,Pumped Storage,0,-1980874,-1980874
2000,NY,Total,0,276158150,276158150
2000,NY,Wind,0,20690,20690
2000,NY,Wood and Wood Derived Fuels,1280650,0,1280650
2000,OH,Coal,259157088,0,259157088
2000,OH,Hydroelectric Conventional,0,1166096,1166096
2000,OH,Natural Gas,1650308,0,1650308
2000,OH,Nuclear,0,33562756,33562756
2000,OH,Other Biomass,53698,0,53698
2000,OH,Other Gases,580706,0,580706
2000,OH,Petroleum,708824,0,708824
2000,OH,Total,0,298120560,298120560
2000,OH,Wood and Wood Derived Fuels,1241084,0,1241084
2000,OK,Coal,71316024,0,71316024
2000,OK,Hydroelectric Conventional,0,4553866,4553866
2000,OK,Natural Gas,35005152,0,35005152
2000,OK,Other Biomass,4862,0,4862
2000,OK,Other Gases,121232,0,121232
2000,OK,Petroleum,105840,0,105840
2000,OK,Pumped Storage,0,-254574,-254574
2000,OK,Total,0,111143914,111143914
2000,OK,Wood and Wood Derived Fuels,291512,0,291512
2000,OR,Coal,7605520,0,7605520
2000,OR,Hydroelectric Conventional,0,76231260,76231260
2000,OR,Natural Gas,18200034,0,18200034
2000,OR,Other Biomass,190600,0,190600
2000,OR,Petroleum,136424,0,136424
2000,OR,Total,0,103579950,103579950
2000,OR,Wind,0,133398,133398
2000,OR,Wood and Wood Derived Fuels,1082714,0,1082714
2000,PA,Coal,232425122,0,232425122
2000,PA,Hydroelectric Conventional,0,4580464,4580464
2000,PA,Natural Gas,5398144,0,5398144
2000,PA,Nuclear,0,147542694,147542694
2000,PA,Other,97502,0,97502
2000,PA,Other Biomass,4057324,0,4057324
2000,PA,Other Gases,1195990,0,1195990
2000,PA,Petroleum,7496310,0,7496310
2000,PA,Pumped Storage,0,-821192,-821192
2000,PA,Total,0,403375960,403375960
2000,PA,Wind,0,19626,19626
2000,PA,Wood and Wood Derived Fuels,1383976,0,1383976
2000,RI,Hydroelectric Conventional,0,9734,9734
2000,RI,Natural Gas,11583628,0,11583628
2000,RI,Other Biomass,230478,0,230478
2000,RI,Petroleum,119250,0,119250
2000,RI,Total,0,11943090,11943090
2000,SC,Coal,78416752,0,78416752
2000,SC,Hydroelectric Conventional,0,3066980,3066980
2000,SC,Natural Gas,1865804,0,1865804
2000,SC,Nuclear,0,101775400,101775400
2000,SC,Other Biomass,137362,0,137362
2000,SC,Other Gases,1776,0,1776
2000,SC,Petroleum,890314,0,890314
2000,SC,Pumped Storage,0,-2164012,-2164012
2000,SC,Total,0,186692480,186692480
2000,SC,Wood and Wood Derived Fuels,2702104,0,2702104
2000,SD,Coal,7341152,0,7341152
2000,SD,Hydroelectric Conventional,0,11431016,11431016
2000,SD,Natural Gas,518078,0,518078
2000,SD,Petroleum,104428,0,104428
2000,SD,Total,0,19394674,19394674
2000,TN,Coal,124439020,0,124439020
2000,TN,Hydroelectric Conventional,0,12792418,12792418
2000,TN,Natural Gas,1297542,0,1297542
2000,TN,Nuclear,0,51649716,51649716
2000,TN,Other,210070,0,210070
2000,TN,Other Biomass,77610,0,77610
2000,TN,Other Gases,27666,0,27666
2000,TN,Petroleum,1124340,0,1124340
2000,TN,Pumped Storage,0,-1462902,-1462902
2000,TN,Total,0,191677168,191677168
2000,TN,Wind,0,0,0
2000,TN,Wood and Wood Derived Fuels,1521688,0,1521688
2000,TX,Coal,281343928,0,281343928
2000,TX,Hydroelectric Conventional,0,1657926,1657926
2000,TX,Natural Gas,377466590,0,377466590
2000,TX,Nuclear,0,75111614,75111614
2000,TX,Other,3136080,0,3136080
2000,TX,Other Biomass,252348,0,252348
2000,TX,Other Gases,7596094,0,7596094
2000,TX,Petroleum,5631284,0,5631284
2000,TX,Solar Thermal and Photovoltaic,0,82,82
2000,TX,Total,0,755484730,755484730
2000,TX,Wind,0,984292,984292
2000,TX,Wood and Wood Derived Fuels,2304492,0,2304492
2000,UT,Coal,68982848,0,68982848
2000,UT,Geothermal,303686,0,303686
2000,UT,Hydroelectric Conventional,0,1492250,1492250
2000,UT,Natural Gas,1780456,0,1780456
2000,UT,Other Biomass,18220,0,18220
2000,UT,Other Gases,515714,0,515714
2000,UT,Petroleum,115942,0,115942
2000,UT,Pumped Storage,0,9032,9032
2000,UT,Total,0,73218148,73218148
2000,VA,Coal,79522632,0,79522632
2000,VA,Hydroelectric Conventional,0,1423966,1423966
2000,VA,Natural Gas,9306654,0,9306654
2000,VA,Nuclear,0,56642182,56642182
2000,VA,Other Biomass,933862,0,933862
2000,VA,Petroleum,5877088,0,5877088
2000,VA,Pumped Storage,0,-2681982,-2681982
2000,VA,Solar Thermal and Photovoltaic,0,0,0
2000,VA,Total,0,154378740,154378740
2000,VA,Wood and Wood Derived Fuels,3354338,0,3354338
2000,VT,Hydroelectric Conventional,0,2442180,2442180
2000,VT,Natural Gas,181580,0,181580
2000,VT,Nuclear,0,9096130,9096130
2000,VT,Other Gases,44834,0,44834
2000,VT,Petroleum,121760,0,121760
2000,VT,Total,0,12606028,12606028
2000,VT,Wind,0,24498,24498
2000,VT,Wood and Wood Derived Fuels,695046,0,695046
2000,WA,Coal,18889128,0,18889128
2000,WA,Hydroelectric Conventional,0,160525778,160525778
2000,WA,Natural Gas,15400452,0,15400452
2000,WA,Nuclear,0,17210464,17210464
2000,WA,Other Biomass,501334,0,501334
2000,WA,Other Gases,495784,0,495784
2000,WA,Petroleum,969024,0,969024
2000,WA,Pumped Storage,0,0,0
2000,WA,Total,0,216473760,216473760
2000,WA,Wood and Wood Derived Fuels,2481796,0,2481796
2000,WI,Coal,84605886,0,84605886
2000,WI,Hydroelectric Conventional,0,3971268,3971268
2000,WI,Natural Gas,4474950,0,4474950
2000,WI,Nuclear,0,23024156,23024156
2000,WI,Other Biomass,620064,0,620064
2000,WI,Petroleum,894874,0,894874
2000,WI,Pumped Storage,0,10400,10400
2000,WI,Total,0,119288834,119288834
2000,WI,Wind,0,5456,5456
2000,WI,Wood and Wood Derived Fuels,1681780,0,1681780
2000,WV,Coal,182404618,0,182404618
2000,WV,Hydroelectric Conventional,0,2301806,2301806
2000,WV,Natural Gas,279038,0,279038
2000,WV,Other,392,0,392
2000,WV,Other Biomass,28864,0,28864
2000,WV,Other Gases,190128,0,190128
2000,WV,Petroleum,525506,0,525506
2000,WV,Total,0,185730352,185730352
2000,WY,Coal,87148216,0,87148216
2000,WY,Hydroelectric Conventional,0,2022070,2022070
2000,WY,Natural Gas,1078272,0,1078272
2000,WY,Other,153142,0,153142
2000,WY,Other Gases,18706,0,18706
2000,WY,Petroleum,76332,0,76332
2000,WY,Total,0,90988560,90988560
2000,WY,Wind,0,491822,491822
2001,AK,Coal,1129186,0,1129186
2001,AK,Hydroelectric Conventional,0,2691330,2691330
2001,AK,Natural Gas,7791138,0,7791138
2001,AK,Petroleum,1873978,0,1873978
2001,AK,Total,0,13487532,13487532
2001,AK,Wind,0,1900,1900
2001,AL,Coal,144396228,0,144396228
2001,AL,Hydroelectric Conventional,0,16712764,16712764
2001,AL,Natural Gas,19225364,0,19225364
2001,AL,Nuclear,0,60714126,60714126
2001,AL,Other,15624,0,15624
2001,AL,Other Biomass,34214,0,34214
2001,AL,Other Gases,378294,0,378294
2001,AL,Petroleum,869098,0,869098
2001,AL,Total,0,250690226,250690226
2001,AL,Wood and Wood Derived Fuels,8344514,0,8344514
2001,AR,Coal,49528942,0,49528942
2001,AR,Hydroelectric Conventional,0,5096500,5096500
2001,AR,Natural Gas,5413800,0,5413800
2001,AR,Nuclear,0,29561578,29561578
2001,AR,Other,470,0,470
2001,AR,Other Biomass,14606,0,14606
2001,AR,Petroleum,1758786,0,1758786
2001,AR,Total,0,94384070,94384070
2001,AR,Wood and Wood Derived Fuels,3009388,0,3009388
2001,AZ,Coal,80122988,0,80122988
2001,AZ,Hydroelectric Conventional,0,15247130,15247130
2001,AZ,Natural Gas,25744400,0,25744400
2001,AZ,Nuclear,0,57448152,57448152
2001,AZ,Other Biomass,77896,0,77896
2001,AZ,Petroleum,628412,0,628412
2001,AZ,Pumped Storage,0,552588,552588
2001,AZ,Solar Thermal and Photovoltaic,0,978,978
2001,AZ,Total,0,179822544,179822544
2001,CA,Coal,4465702,0,4465702
2001,CA,Geothermal,24362588,0,24362588
2001,CA,Hydroelectric Conventional,0,51083552,51083552
2001,CA,Natural Gas,223864542,0,223864542
2001,CA,Nuclear,0,66439040,66439040
2001,CA,Other,408676,0,408676
2001,CA,Other Biomass,4165072,0,4165072
2001,CA,Other Gases,2260998,0,2260998
2001,CA,Petroleum,6109786,0,6109786
2001,CA,Pumped Storage,0,-699378,-699378
2001,CA,Solar Thermal and Photovoltaic,0,1084542,1084542
2001,CA,Total,0,397192150,397192150
2001,CA,Wind,0,6999476,6999476
2001,CA,Wood and Wood Derived Fuels,6647554,0,6647554
2001,CO,Coal,71902056,0,71902056
2001,CO,Hydroelectric Conventional,0,2989394,2989394
2001,CO,Natural Gas,18783574,0,18783574
2001,CO,Other,0,0,0
2001,CO,Other Biomass,128406,0,128406
2001,CO,Petroleum,352458,0,352458
2001,CO,Pumped Storage,0,-501164,-501164
2001,CO,Total,0,93752004,93752004
2001,CO,Wind,0,97280,97280
2001,CT,Coal,7471564,0,7471564
2001,CT,Hydroelectric Conventional,0,572746,572746
2001,CT,Natural Gas,8176456,0,8176456
2001,CT,Nuclear,0,30855534,30855534
2001,CT,Other,1738278,0,1738278
2001,CT,Other Biomass,1817848,0,1817848
2001,CT,Other Gases,2996,0,2996
2001,CT,Petroleum,10345870,0,10345870
2001,CT,Pumped Storage,0,0,0
2001,CT,Total,0,60981292,60981292
2001,DC,Petroleum,246478,0,246478
2001,DC,Total,0,246478,246478
2001,DE,Coal,6737014,0,6737014
2001,DE,Natural Gas,3150972,0,3150972
2001,DE,Other Gases,314124,0,314124
2001,DE,Petroleum,3413258,0,3413258
2001,DE,Total,0,13615368,13615368
2001,FL,Coal,136455476,0,136455476
2001,FL,Hydroelectric Conventional,0,295436,295436
2001,FL,Natural Gas,87139610,0,87139610
2001,FL,Nuclear,0,63166808,63166808
2001,FL,Other,6092698,0,6092698
2001,FL,Other Biomass,3923042,0,3923042
2001,FL,Other Gases,1268,0,1268
2001,FL,Petroleum,81159878,0,81159878
2001,FL,Total,0,381890688,381890688
2001,FL,Wood and Wood Derived Fuels,3656472,0,3656472
2001,GA,Coal,149122362,0,149122362
2001,GA,Hydroelectric Conventional,0,5192854,5192854
2001,GA,Natural Gas,7731746,0,7731746
2001,GA,Nuclear,0,67363538,67363538
2001,GA,Other,15912,0,15912
2001,GA,Other Biomass,56840,0,56840
2001,GA,Petroleum,2341078,0,2341078
2001,GA,Pumped Storage,0,-1139420,-1139420
2001,GA,Total,0,236633578,236633578
2001,GA,Wood and Wood Derived Fuels,5948668,0,5948668
2001,HI,Coal,3209528,0,3209528
2001,HI,Geothermal,413184,0,413184
2001,HI,Hydroelectric Conventional,0,201500,201500
2001,HI,Natural Gas,0,0,0
2001,HI,Other,338955,0,338955
2001,HI,Other Biomass,575417,0,575417
2001,HI,Other Gases,75710,0,75710
2001,HI,Petroleum,16447648,0,16447648
2001,HI,Total,0,21266186,21266186
2001,HI,Wind,0,4244,4244
2001,IA,Coal,69330190,0,69330190
2001,IA,Hydroelectric Conventional,0,1690308,1690308
2001,IA,Natural Gas,1185704,0,1185704
2001,IA,Nuclear,0,7705444,7705444
2001,IA,Other,16898,0,16898
2001,IA,Other Biomass,207496,0,207496
2001,IA,Petroleum,205256,0,205256
2001,IA,Total,0,81317024,81317024
2001,IA,Wind,0,975728,975728
2001,ID,Coal,144568,0,144568
2001,ID,Hydroelectric Conventional,0,14446252,14446252
2001,ID,Natural Gas,2810572,0,2810572
2001,ID,Other,218374,0,218374
2001,ID,Petroleum,7446,0,7446
2001,ID,Total,0,18693882,18693882
2001,ID,Wood and Wood Derived Fuels,1066670,0,1066670
2001,IL,Coal,159101274,0,159101274
2001,IL,Hydroelectric Conventional,0,288054,288054
2001,IL,Natural Gas,9212586,0,9212586
2001,IL,Nuclear,0,184716954,184716954
2001,IL,Other,99001,0,99001
2001,IL,Other Biomass,1357139,0,1357139
2001,IL,Other Gases,711552,0,711552
2001,IL,Petroleum,3012010,0,3012010
2001,IL,Total,0,358498570,358498570
2001,IN,Coal,232133024,0,232133024
2001,IN,Hydroelectric Conventional,0,1141384,1141384
2001,IN,Natural Gas,4663320,0,4663320
2001,IN,Other,31876,0,31876
2001,IN,Other Biomass,229160,0,229160
2001,IN,Other Gases,5957618,0,5957618
2001,IN,Petroleum,982964,0,982964
2001,IN,Total,0,245139346,245139346
2001,KS,Coal,63536002,0,63536002
2001,KS,Hydroelectric Conventional,0,51124,51124
2001,KS,Natural Gas,3902600,0,3902600
2001,KS,Nuclear,0,20693302,20693302
2001,KS,Petroleum,1234354,0,1234354
2001,KS,Total,0,89497046,89497046
2001,KS,Wind,0,79664,79664
2001,KY,Coal,181597156,0,181597156
2001,KY,Hydroelectric Conventional,0,7711016,7711016
2001,KY,Natural Gas,1260854,0,1260854
2001,KY,Petroleum,247120,0,247120
2001,KY,Total,0,190835252,190835252
2001,KY,Wood and Wood Derived Fuels,19106,0,19106
2001,LA,Coal,43936292,0,43936292
2001,LA,Hydroelectric Conventional,0,1464434,1464434
2001,LA,Natural Gas,80745508,0,80745508
2001,LA,Nuclear,0,34672270,34672270
2001,LA,Other,1780706,0,1780706
2001,LA,Other Biomass,127272,0,127272
2001,LA,Other Gases,881088,0,881088
2001,LA,Petroleum,6899878,0,6899878
2001,LA,Total,0,175788754,175788754
2001,LA,Wood and Wood Derived Fuels,5281306,0,5281306
2001,MA,Coal,22102666,0,22102666
2001,MA,Hydroelectric Conventional,0,1405010,1405010
2001,MA,Natural Gas,23394008,0,23394008
2001,MA,Nuclear,0,10288066,10288066
2001,MA,Other,1541098,0,1541098
2001,MA,Other Biomass,2366036,0,2366036
2001,MA,Other Gases,0,0,0
2001,MA,Petroleum,17023144,0,17023144
2001,MA,Pumped Storage,0,-1422698,-1422698
2001,MA,Total,0,76956868,76956868
2001,MA,Wood and Wood Derived Fuels,259538,0,259538
2001,MD,Coal,56758818,0,56758818
2001,MD,Hydroelectric Conventional,0,2367036,2367036
2001,MD,Natural Gas,3521624,0,3521624
2001,MD,Nuclear,0,27312534,27312534
2001,MD,Other,495400,0,495400
2001,MD,Other Biomass,722152,0,722152
2001,MD,Other Gases,879960,0,879960
2001,MD,Petroleum,6043278,0,6043278
2001,MD,Total,0,98124680,98124680
2001,MD,Wood and Wood Derived Fuels,23878,0,23878
2001,ME,Coal,1056824,0,1056824
2001,ME,Hydroelectric Conventional,0,5290246,5290246
2001,ME,Natural Gas,20105898,0,20105898
2001,ME,Other,822181,0,822181
2001,ME,Other Biomass,591170,0,591170
2001,ME,Other Gases,0,0,0
2001,ME,Petroleum,4203044,0,4203044
2001,ME,Total,0,39129642,39129642
2001,ME,Wood and Wood Derived Fuels,7060280,0,7060280
2001,MI,Coal,136526328,0,136526328
2001,MI,Hydroelectric Conventional,0,3123846,3123846
2001,MI,Natural Gas,26347022,0,26347022
2001,MI,Nuclear,0,53421564,53421564
2001,MI,Other,291806,0,291806
2001,MI,Other Biomass,1322242,0,1322242
2001,MI,Other Gases,11228,0,11228
2001,MI,Petroleum,1499774,0,1499774
2001,MI,Pumped Storage,0,-2253674,-2253674
2001,MI,Total,0,223691220,223691220
2001,MI,Wind,0,560,560
2001,MI,Wood and Wood Derived Fuels,3400524,0,3400524
2001,MN,Coal,63638326,0,63638326
2001,MN,Hydroelectric Conventional,0,1663236,1663236
2001,MN,Natural Gas,2399154,0,2399154
2001,MN,Nuclear,0,23578054,23578054
2001,MN,Other,563344,0,563344
2001,MN,Other Biomass,1010768,0,1010768
2001,MN,Petroleum,1250112,0,1250112
2001,MN,Total,0,97046452,97046452
2001,MN,Wind,0,1794036,1794036
2001,MN,Wood and Wood Derived Fuels,1149422,0,1149422
2001,MO,Coal,131497366,0,131497366
2001,MO,Hydroelectric Conventional,0,2208270,2208270
2001,MO,Natural Gas,7747124,0,7747124
2001,MO,Nuclear,0,16768480,16768480
2001,MO,Other,107260,0,107260
2001,MO,Other Biomass,17596,0,17596
2001,MO,Petroleum,1275370,0,1275370
2001,MO,Pumped Storage,0,-531720,-531720
2001,MO,Total,0,159089746,159089746
2001,MS,Coal,38392130,0,38392130
2001,MS,Natural Gas,35501104,0,35501104
2001,MS,Nuclear,0,19847764,19847764
2001,MS,Other,292,0,292
2001,MS,Other Biomass,2,0,2
2001,MS,Other Gases,0,0,0
2001,MS,Petroleum,10287380,0,10287380
2001,MS,Total,0,106892904,106892904
2001,MS,Wood and Wood Derived Fuels,2864232,0,2864232
2001,MT,Coal,34071766,0,34071766
2001,MT,Hydroelectric Conventional,0,13226948,13226948
2001,MT,Natural Gas,40178,0,40178
2001,MT,Petroleum,995228,0,995228
2001,MT,Total,0,48464970,48464970
2001,MT,Wood and Wood Derived Fuels,130850,0,130850
2001,NC,Coal,145915534,0,145915534
2001,NC,Hydroelectric Conventional,0,5191410,5191410
2001,NC,Natural Gas,3068710,0,3068710
2001,NC,Nuclear,0,75550050,75550050
2001,NC,Other,449947,0,449947
2001,NC,Other Biomass,217921,0,217921
2001,NC,Other Gases,1982,0,1982
2001,NC,Petroleum,1311488,0,1311488
2001,NC,Pumped Storage,0,0,0
2001,NC,Total,0,234991700,234991700
2001,NC,Wood and Wood Derived Fuels,3284658,0,3284658
2001,ND,Coal,57754350,0,57754350
2001,ND,Hydroelectric Conventional,0,2664152,2664152
2001,ND,Natural Gas,5072,0,5072
2001,ND,Other Biomass,15330,0,15330
2001,ND,Other Gases,129468,0,129468
2001,ND,Petroleum,95772,0,95772
2001,ND,Total,0,60664144,60664144
2001,NE,Coal,40477412,0,40477412
2001,NE,Hydroelectric Conventional,0,2248244,2248244
2001,NE,Natural Gas,697462,0,697462
2001,NE,Nuclear,0,17452226,17452226
2001,NE,Other,116,0,116
2001,NE,Other Biomass,33326,0,33326
2001,NE,Petroleum,56378,0,56378
2001,NE,Total,0,60970424,60970424
2001,NE,Wind,0,5260,5260
2001,NH,Coal,7412798,0,7412798
2001,NH,Hydroelectric Conventional,0,1981158,1981158
2001,NH,Natural Gas,237052,0,237052
2001,NH,Nuclear,0,17385486,17385486
2001,NH,Other,118158,0,118158
2001,NH,Other Biomass,333708,0,333708
2001,NH,Petroleum,963354,0,963354
2001,NH,Total,0,30149248,30149248
2001,NH,Wood and Wood Derived Fuels,1717534,0,1717534
2001,NJ,Coal,18638080,0,18638080
2001,NJ,Hydroelectric Conventional,0,36004,36004
2001,NJ,Natural Gas,33416402,0,33416402
2001,NJ,Nuclear,0,60938460,60938460
2001,NJ,Other,918770,0,918770
2001,NJ,Other Biomass,1687264,0,1687264
2001,NJ,Other Gases,897770,0,897770
2001,NJ,Petroleum,2593250,0,2593250
2001,NJ,Pumped Storage,0,-283480,-283480
2001,NJ,Total,0,118842520,118842520
2001,NM,Coal,56804374,0,56804374
2001,NM,Hydroelectric Conventional,0,474640,474640
2001,NM,Natural Gas,9774544,0,9774544
2001,NM,Other Biomass,37304,0,37304
2001,NM,Petroleum,132424,0,132424
2001,NM,Total,0,67223286,67223286
2001,NV,Coal,35473940,0,35473940
2001,NV,Geothermal,2399746,0,2399746
2001,NV,Hydroelectric Conventional,0,5027444,5027444
2001,NV,Natural Gas,23027546,0,23027546
2001,NV,Petroleum,1823256,0,1823256
2001,NV,Total,0,67751932,67751932
2001,NY,Coal,46863844,0,46863844
2001,NY,Hydroelectric Conventional,0,46167910,46167910
2001,NY,Natural Gas,77394430,0,77394430
2001,NY,Nuclear,0,80789970,80789970
2001,NY,Other,1618600,0,1618600
2001,NY,Other Biomass,2555698,0,2555698
2001,NY,Other Gases,229074,0,229074
2001,NY,Petroleum,33024186,0,33024186
2001,NY,Pumped Storage,0,-1861040,-1861040
2001,NY,Total,0,287829118,287829118
2001,NY,Wind,0,41078,41078
2001,NY,Wood and Wood Derived Fuels,1005368,0,1005368
2001,OH,Coal,248426472,0,248426472
2001,OH,Hydroelectric Conventional,0,1021570,1021570
2001,OH,Natural Gas,1848832,0,1848832
2001,OH,Nuclear,0,30927524,30927524
2001,OH,Other Biomass,55776,0,55776
2001,OH,Other Gases,603898,0,603898
2001,OH,Petroleum,833396,0,833396
2001,OH,Total,0,284523614,284523614
2001,OH,Wood and Wood Derived Fuels,806146,0,806146
2001,OK,Coal,69231536,0,69231536
2001,OK,Hydroelectric Conventional,0,4689380,4689380
2001,OK,Natural Gas,35887616,0,35887616
2001,OK,Other Gases,135584,0,135584
2001,OK,Petroleum,350350,0,350350
2001,OK,Pumped Storage,0,-256958,-256958
2001,OK,Total,0,110498900,110498900
2001,OK,Wood and Wood Derived Fuels,461392,0,461392
2001,OR,Coal,8890106,0,8890106
2001,OR,Hydroelectric Conventional,0,57289104,57289104
2001,OR,Natural Gas,21965930,0,21965930
2001,OR,Other,75170,0,75170
2001,OR,Other Biomass,99646,0,99646
2001,OR,Petroleum,204446,0,204446
2001,OR,Total,0,90103812,90103812
2001,OR,Wind,0,177174,177174
2001,OR,Wood and Wood Derived Fuels,1402236,0,1402236
2001,PA,Coal,223800896,0,223800896
2001,PA,Hydroelectric Conventional,0,3300008,3300008
2001,PA,Natural Gas,6072594,0,6072594
2001,PA,Nuclear,0,147461594,147461594
2001,PA,Other,1605150,0,1605150
2001,PA,Other Biomass,2576570,0,2576570
2001,PA,Other Gases,1226274,0,1226274
2001,PA,Petroleum,7125174,0,7125174
2001,PA,Pumped Storage,0,-1230900,-1230900
2001,PA,Total,0,393153182,393153182
2001,PA,Wind,0,22350,22350
2001,PA,Wood and Wood Derived Fuels,1193472,0,1193472
2001,RI,Hydroelectric Conventional,0,6286,6286
2001,RI,Natural Gas,14650260,0,14650260
2001,RI,Other Biomass,207232,0,207232
2001,RI,Petroleum,140006,0,140006
2001,RI,Total,0,15003784,15003784
2001,SC,Coal,73398008,0,73398008
2001,SC,Hydroelectric Conventional,0,2450886,2450886
2001,SC,Natural Gas,2352228,0,2352228
2001,SC,Nuclear,0,99739996,99739996
2001,SC,Other,43387,0,43387
2001,SC,Other Biomass,56089,0,56089
2001,SC,Other Gases,396,0,396
2001,SC,Petroleum,616210,0,616210
2001,SC,Pumped Storage,0,-2071444,-2071444
2001,SC,Total,0,178317974,178317974
2001,SC,Wood and Wood Derived Fuels,1732218,0,1732218
2001,SD,Coal,7223360,0,7223360
2001,SD,Hydroelectric Conventional,0,6863730,6863730
2001,SD,Natural Gas,609606,0,609606
2001,SD,Petroleum,103048,0,103048
2001,SD,Total,0,14801486,14801486
2001,SD,Wind,0,1742,1742
2001,TN,Coal,119460064,0,119460064
2001,TN,Hydroelectric Conventional,0,13893058,13893058
2001,TN,Natural Gas,911006,0,911006
2001,TN,Nuclear,0,57152862,57152862
2001,TN,Other,13240,0,13240
2001,TN,Other Biomass,85196,0,85196
2001,TN,Other Gases,36992,0,36992
2001,TN,Petroleum,800128,0,800128
2001,TN,Pumped Storage,0,-1467448,-1467448
2001,TN,Total,0,192443952,192443952
2001,TN,Wood and Wood Derived Fuels,1558854,0,1558854
2001,TX,Coal,270199842,0,270199842
2001,TX,Hydroelectric Conventional,0,2400664,2400664
2001,TX,Natural Gas,380221962,0,380221962
2001,TX,Nuclear,0,76325726,76325726
2001,TX,Other,2894464,0,2894464
2001,TX,Other Biomass,191658,0,191658
2001,TX,Other Gases,3148650,0,3148650
2001,TX,Petroleum,5606806,0,5606806
2001,TX,Solar Thermal and Photovoltaic,0,-10,-10
2001,TX,Total,0,745160004,745160004
2001,TX,Wind,0,2375020,2375020
2001,TX,Wood and Wood Derived Fuels,1795222,0,1795222
2001,UT,Coal,67358616,0,67358616
2001,UT,Geothermal,305484,0,305484
2001,UT,Hydroelectric Conventional,0,1016810,1016810
2001,UT,Natural Gas,2892154,0,2892154
2001,UT,Other,8292,0,8292
2001,UT,Other Biomass,10992,0,10992
2001,UT,Petroleum,115152,0,115152
2001,UT,Total,0,71707500,71707500
2001,VA,Coal,75539822,0,75539822
2001,VA,Hydroelectric Conventional,0,2028448,2028448
2001,VA,Natural Gas,8392142,0,8392142
2001,VA,Nuclear,0,51518260,51518260
2001,VA,Other,793612,0,793612
2001,VA,Other Biomass,1197938,0,1197938
2001,VA,Other Gases,0,0,0
2001,VA,Petroleum,10923226,0,10923226
2001,VA,Pumped Storage,0,-4480154,-4480154
2001,VA,Solar Thermal and Photovoltaic,0,0,0
2001,VA,Total,0,148209500,148209500
2001,VA,Wood and Wood Derived Fuels,2296206,0,2296206
2001,VT,Hydroelectric Conventional,0,1768426,1768426
2001,VT,Natural Gas,22000,0,22000
2001,VT,Nuclear,0,8342240,8342240
2001,VT,Petroleum,63480,0,63480
2001,VT,Total,0,10961228,10961228
2001,VT,Wind,0,24266,24266
2001,VT,Wood and Wood Derived Fuels,740816,0,740816
2001,WA,Coal,18164716,0,18164716
2001,WA,Hydroelectric Conventional,0,109467790,109467790
2001,WA,Natural Gas,18748490,0,18748490
2001,WA,Nuclear,0,16500858,16500858
2001,WA,Other,132104,0,132104
2001,WA,Other Biomass,312472,0,312472
2001,WA,Petroleum,640718,0,640718
2001,WA,Total,0,166097338,166097338
2001,WA,Wood and Wood Derived Fuels,2130190,0,2130190
2001,WI,Coal,82506912,0,82506912
2001,WI,Hydroelectric Conventional,0,4112488,4112488
2001,WI,Natural Gas,4467930,0,4467930
2001,WI,Nuclear,0,23014156,23014156
2001,WI,Other,325390,0,325390
2001,WI,Other Biomass,649152,0,649152
2001,WI,Petroleum,895566,0,895566
2001,WI,Total,0,117526862,117526862
2001,WI,Wind,0,144568,144568
2001,WI,Wood and Wood Derived Fuels,1410700,0,1410700
2001,WV,Coal,160428808,0,160428808
2001,WV,Hydroelectric Conventional,0,1903886,1903886
2001,WV,Natural Gas,551730,0,551730
2001,WV,Other,21620,0,21620
2001,WV,Other Biomass,28658,0,28658
2001,WV,Other Gases,179000,0,179000
2001,WV,Petroleum,557352,0,557352
2001,WV,Total,0,163673450,163673450
2001,WV,Wood and Wood Derived Fuels,2396,0,2396
2001,WY,Coal,85578620,0,85578620
2001,WY,Hydroelectric Conventional,0,1758222,1758222
2001,WY,Natural Gas,1183684,0,1183684
2001,WY,Other,215818,0,215818
2001,WY,Other Gases,15022,0,15022
2001,WY,Petroleum,72192,0,72192
2001,WY,Total,0,89553876,89553876
2001,WY,Wind,0,730318,730318
2002,AK,Coal,1150576,0,1150576
2002,AK,Hydroelectric Conventional,0,2878702,2878702
2002,AK,Natural Gas,7556324,0,7556324
2002,AK,Other Biomass,22248,0,22248
2002,AK,Petroleum,1924738,0,1924738
2002,AK,Total,0,13534650,13534650
2002,AK,Wood and Wood Derived Fuels,2062,0,2062
2002,AL,Coal,144083328,0,144083328
2002,AL,Hydroelectric Conventional,0,17649574,17649574
2002,AL,Natural Gas,31808130,0,31808130
2002,AL,Nuclear,0,63713852,63713852
2002,AL,Other,245490,0,245490
2002,AL,Other Biomass,36802,0,36802
2002,AL,Other Gases,225082,0,225082
2002,AL,Petroleum,624096,0,624096
2002,AL,Total,0,265841340,265841340
2002,AL,Wood and Wood Derived Fuels,7454986,0,7454986
2002,AR,Coal,46196740,0,46196740
2002,AR,Hydroelectric Conventional,0,6871658,6871658
2002,AR,Natural Gas,9205916,0,9205916
2002,AR,Nuclear,0,29117768,29117768
2002,AR,Other,341262,0,341262
2002,AR,Other Biomass,9316,0,9316
2002,AR,Petroleum,319412,0,319412
2002,AR,Total,0,95223290,95223290
2002,AR,Wood and Wood Derived Fuels,3161216,0,3161216
2002,AZ,Coal,76453262,0,76453262
2002,AZ,Hydroelectric Conventional,0,14854360,14854360
2002,AZ,Natural Gas,34586030,0,34586030
2002,AZ,Nuclear,0,61723822,61723822
2002,AZ,Other,175428,0,175428
2002,AZ,Other Biomass,106692,0,106692
2002,AZ,Petroleum,114892,0,114892
2002,AZ,Pumped Storage,0,247928,247928
2002,AZ,Solar Thermal and Photovoltaic,0,918,918
2002,AZ,Total,0,188263332,188263332
2002,CA,Coal,4655618,0,4655618
2002,CA,Geothermal,26147230,0,26147230
2002,CA,Hydroelectric Conventional,0,62281256,62281256
2002,CA,Natural Gas,179248088,0,179248088
2002,CA,Nuclear,0,68704680,68704680
2002,CA,Other,796216,0,796216
2002,CA,Other Biomass,4037518,0,4037518
2002,CA,Other Gases,2480106,0,2480106
2002,CA,Petroleum,3922131,0,3922131
2002,CA,Pumped Storage,0,-481994,-481994
2002,CA,Solar Thermal and Photovoltaic,0,1108744,1108744
2002,CA,Total,0,368420063,368420063
2002,CA,Wind,0,7605290,7605290
2002,CA,Wood and Wood Derived Fuels,7915178,0,7915178
2002,CO,Coal,70776502,0,70776502
2002,CO,Hydroelectric Conventional,0,2418014,2418014
2002,CO,Natural Gas,18056980,0,18056980
2002,CO,Other,0,0,0
2002,CO,Other Biomass,59668,0,59668
2002,CO,Other Gases,5768,0,5768
2002,CO,Petroleum,46360,0,46360
2002,CO,Pumped Storage,0,-440528,-440528
2002,CO,Total,0,91200776,91200776
2002,CO,Wind,0,278012,278012
2002,CT,Coal,6454404,0,6454404
2002,CT,Hydroelectric Conventional,0,670176,670176
2002,CT,Natural Gas,17736941,0,17736941
2002,CT,Nuclear,0,29836544,29836544
2002,CT,Other,1608644,0,1608644
2002,CT,Other Biomass,1642692,0,1642692
2002,CT,Other Gases,17668,0,17668
2002,CT,Petroleum,4675770,0,4675770
2002,CT,Pumped Storage,0,-20402,-20402
2002,CT,Total,0,62622439,62622439
2002,DC,Petroleum,523960,0,523960
2002,DC,Total,0,523960,523960
2002,DE,Coal,6927130,0,6927130
2002,DE,Natural Gas,2885766,0,2885766
2002,DE,Other Gases,292692,0,292692
2002,DE,Petroleum,1899390,0,1899390
2002,DE,Total,0,12004978,12004978
2002,FL,Coal,131852786,0,131852786
2002,FL,Hydroelectric Conventional,0,368228,368228
2002,FL,Natural Gas,126328070,0,126328070
2002,FL,Nuclear,0,67408460,67408460
2002,FL,Other,5879585,0,5879585
2002,FL,Other Biomass,4373778,0,4373778
2002,FL,Other Gases,26158,0,26158
2002,FL,Petroleum,67362702,0,67362702
2002,FL,Total,0,406705549,406705549
2002,FL,Wood and Wood Derived Fuels,3105782,0,3105782
2002,GA,Coal,157656248,0,157656248
2002,GA,Hydroelectric Conventional,0,5431444,5431444
2002,GA,Natural Gas,13778300,0,13778300
2002,GA,Nuclear,0,62215470,62215470
2002,GA,Other,67304,0,67304
2002,GA,Other Biomass,324914,0,324914
2002,GA,Petroleum,2409130,0,2409130
2002,GA,Pumped Storage,0,-1296336,-1296336
2002,GA,Total,0,253024430,253024430
2002,GA,Wood and Wood Derived Fuels,12437956,0,12437956
2002,HI,Coal,3091594,0,3091594
2002,HI,Geothermal,145522,0,145522
2002,HI,Hydroelectric Conventional,0,190136,190136
2002,HI,Other,286962,0,286962
2002,HI,Other Biomass,593086,0,593086
2002,HI,Other Gases,81632,0,81632
2002,HI,Petroleum,18933980,0,18933980
2002,HI,Total,0,23326140,23326140
2002,HI,Wind,0,3228,3228
2002,IA,Coal,70744117,0,70744117
2002,IA,Hydroelectric Conventional,0,1892766,1892766
2002,IA,Natural Gas,1109438,0,1109438
2002,IA,Nuclear,0,9147916,9147916
2002,IA,Other,468,0,468
2002,IA,Other Biomass,196484,0,196484
2002,IA,Petroleum,127728,0,127728
2002,IA,Total,0,85056769,85056769
2002,IA,Wind,0,1837670,1837670
2002,IA,Wood and Wood Derived Fuels,182,0,182
2002,ID,Coal,181346,0,181346
2002,ID,Hydroelectric Conventional,0,17538642,17538642
2002,ID,Natural Gas,657976,0,657976
2002,ID,Other,179166,0,179166
2002,ID,Petroleum,130,0,130
2002,ID,Total,0,19573866,19573866
2002,ID,Wood and Wood Derived Fuels,1016606,0,1016606
2002,IL,Coal,173370694,0,173370694
2002,IL,Hydroelectric Conventional,0,257644,257644
2002,IL,Natural Gas,18157470,0,18157470
2002,IL,Nuclear,0,181720216,181720216
2002,IL,Other,244792,0,244792
2002,IL,Other Biomass,1447016,0,1447016
2002,IL,Other Gases,465700,0,465700
2002,IL,Petroleum,445366,0,445366
2002,IL,Total,0,376108898,376108898
2002,IN,Coal,235319400,0,235319400
2002,IN,Hydroelectric Conventional,0,822540,822540
2002,IN,Natural Gas,7564902,0,7564902
2002,IN,Other,31284,0,31284
2002,IN,Other Biomass,231892,0,231892
2002,IN,Other Gases,6011996,0,6011996
2002,IN,Petroleum,1234264,0,1234264
2002,IN,Total,0,251216279,251216279
2002,KS,Coal,70738378,0,70738378
2002,KS,Hydroelectric Conventional,0,25492,25492
2002,KS,Natural Gas,3578104,0,3578104
2002,KS,Nuclear,0,18083404,18083404
2002,KS,Petroleum,1018156,0,1018156
2002,KS,Total,0,94376892,94376892
2002,KS,Wind,0,933358,933358
2002,KY,Coal,166548492,0,166548492
2002,KY,Hydroelectric Conventional,0,8049498,8049498
2002,KY,Natural Gas,2747420,0,2747420
2002,KY,Petroleum,6136996,0,6136996
2002,KY,Total,0,184213336,184213336
2002,KY,Wood and Wood Derived Fuels,730930,0,730930
2002,LA,Coal,44101812,0,44101812
2002,LA,Hydroelectric Conventional,0,1782882,1782882
2002,LA,Natural Gas,95801695,0,95801695
2002,LA,Nuclear,0,34610656,34610656
2002,LA,Other,1299602,0,1299602
2002,LA,Other Biomass,123160,0,123160
2002,LA,Other Gases,2995248,0,2995248
2002,LA,Petroleum,3729072,0,3729072
2002,LA,Total,0,189941927,189941927
2002,LA,Wood and Wood Derived Fuels,5497800,0,5497800
2002,MA,Coal,23005722,0,23005722
2002,MA,Hydroelectric Conventional,0,1750152,1750152
2002,MA,Natural Gas,31737949,0,31737949
2002,MA,Nuclear,0,11537532,11537532
2002,MA,Other,1565008,0,1565008
2002,MA,Other Biomass,2330910,0,2330910
2002,MA,Petroleum,13600589,0,13600589
2002,MA,Pumped Storage,0,-1685602,-1685602
2002,MA,Total,0,84055635,84055635
2002,MA,Wind,0,0,0
2002,MA,Wood and Wood Derived Fuels,213374,0,213374
2002,MD,Coal,57424106,0,57424106
2002,MD,Hydroelectric Conventional,0,3321978,3321978
2002,MD,Natural Gas,4428862,0,4428862
2002,MD,Nuclear,0,24256010,24256010
2002,MD,Other,510068,0,510068
2002,MD,Other Biomass,677454,0,677454
2002,MD,Other Gases,1009026,0,1009026
2002,MD,Petroleum,4564864,0,4564864
2002,MD,Total,0,96558176,96558176
2002,MD,Wood and Wood Derived Fuels,365808,0,365808
2002,ME,Coal,1207876,0,1207876
2002,ME,Hydroelectric Conventional,0,5535695,5535695
2002,ME,Natural Gas,27007926,0,27007926
2002,ME,Other,772438,0,772438
2002,ME,Other Biomass,639547,0,639547
2002,ME,Other Gases,96,0,96
2002,ME,Petroleum,2458971,0,2458971
2002,ME,Total,0,45070067,45070067
2002,ME,Wood and Wood Derived Fuels,7447518,0,7447518
2002,MI,Coal,133399016,0,133399016
2002,MI,Hydroelectric Conventional,0,3338504,3338504
2002,MI,Natural Gas,31706836,0,31706836
2002,MI,Nuclear,0,62174908,62174908
2002,MI,Other,562834,0,562834
2002,MI,Other Biomass,1490248,0,1490248
2002,MI,Other Gases,20216,0,20216
2002,MI,Petroleum,2206970,0,2206970
2002,MI,Pumped Storage,0,-2071120,-2071120
2002,MI,Total,0,235778174,235778174
2002,MI,Wind,0,658,658
2002,MI,Wood and Wood Derived Fuels,2949104,0,2949104
2002,MN,Coal,67840418,0,67840418
2002,MN,Hydroelectric Conventional,0,1618168,1618168
2002,MN,Natural Gas,3183907,0,3183907
2002,MN,Nuclear,0,27369648,27369648
2002,MN,Other,664836,0,664836
2002,MN,Other Biomass,1006912,0,1006912
2002,MN,Petroleum,1305581,0,1305581
2002,MN,Total,0,105555932,105555932
2002,MN,Wind,0,1811678,1811678
2002,MN,Wood and Wood Derived Fuels,754784,0,754784
2002,MO,Coal,134869934,0,134869934
2002,MO,Hydroelectric Conventional,0,2713856,2713856
2002,MO,Natural Gas,7087875,0,7087875
2002,MO,Nuclear,0,16779258,16779258
2002,MO,Other,115284,0,115284
2002,MO,Other Biomass,17120,0,17120
2002,MO,Petroleum,1058790,0,1058790
2002,MO,Pumped Storage,0,-318008,-318008
2002,MO,Total,0,162324395,162324395
2002,MO,Wood and Wood Derived Fuels,286,0,286
2002,MS,Coal,29706286,0,29706286
2002,MS,Natural Gas,33942794,0,33942794
2002,MS,Nuclear,0,20118918,20118918
2002,MS,Other,0,0,0
2002,MS,Other Biomass,4,0,4
2002,MS,Other Gases,75832,0,75832
2002,MS,Petroleum,60604,0,60604
2002,MS,Total,0,85777624,85777624
2002,MS,Wood and Wood Derived Fuels,1873186,0,1873186
2002,MT,Coal,30675658,0,30675658
2002,MT,Hydroelectric Conventional,0,19133818,19133818
2002,MT,Natural Gas,33356,0,33356
2002,MT,Other Gases,38320,0,38320
2002,MT,Petroleum,939318,0,939318
2002,MT,Total,0,50947410,50947410
2002,MT,Wood and Wood Derived Fuels,126940,0,126940
2002,NC,Coal,150375482,0,150375482
2002,NC,Hydroelectric Conventional,0,6984096,6984096
2002,NC,Natural Gas,7121741,0,7121741
2002,NC,Nuclear,0,79253698,79253698
2002,NC,Other,392404,0,392404
2002,NC,Other Biomass,206902,0,206902
2002,NC,Other Gases,1726,0,1726
2002,NC,Petroleum,1184052,0,1184052
2002,NC,Pumped Storage,0,50350,50350
2002,NC,Total,0,248936059,248936059
2002,NC,Wood and Wood Derived Fuels,3365608,0,3365608
2002,ND,Coal,59223048,0,59223048
2002,ND,Hydroelectric Conventional,0,3185232,3185232
2002,ND,Natural Gas,16084,0,16084
2002,ND,Other Biomass,820,0,820
2002,ND,Other Gases,110288,0,110288
2002,ND,Petroleum,77152,0,77152
2002,ND,Total,0,62612624,62612624
2002,NE,Coal,39887814,0,39887814
2002,NE,Hydroelectric Conventional,0,2194972,2194972
2002,NE,Natural Gas,826276,0,826276
2002,NE,Nuclear,0,20244484,20244484
2002,NE,Other,0,0,0
2002,NE,Other Biomass,25986,0,25986
2002,NE,Other Gases,202,0,202
2002,NE,Petroleum,41098,0,41098
2002,NE,Total,0,63236988,63236988
2002,NE,Wind,0,16156,16156
2002,NH,Coal,7444772,0,7444772
2002,NH,Hydroelectric Conventional,0,2281880,2281880
2002,NH,Natural Gas,440738,0,440738
2002,NH,Nuclear,0,18589234,18589234
2002,NH,Other,120206,0,120206
2002,NH,Other Biomass,330374,0,330374
2002,NH,Petroleum,1299418,0,1299418
2002,NH,Total,0,31906156,31906156
2002,NH,Wood and Wood Derived Fuels,1399534,0,1399534
2002,NJ,Coal,19210108,0,19210108
2002,NJ,Hydroelectric Conventional,0,24060,24060
2002,NJ,Natural Gas,38138716,0,38138716
2002,NJ,Nuclear,0,61731350,61731350
2002,NJ,Other,989510,0,989510
2002,NJ,Other Biomass,1694398,0,1694398
2002,NJ,Other Gases,180966,0,180966
2002,NJ,Petroleum,1461266,0,1461266
2002,NJ,Pumped Storage,0,-291600,-291600
2002,NJ,Total,0,123138773,123138773
2002,NM,Coal,53805760,0,53805760
2002,NM,Hydroelectric Conventional,0,529182,529182
2002,NM,Natural Gas,6883478,0,6883478
2002,NM,Other Biomass,38816,0,38816
2002,NM,Petroleum,66178,0,66178
2002,NM,Total,0,61323414,61323414
2002,NV,Coal,32826050,0,32826050
2002,NV,Geothermal,2254566,0,2254566
2002,NV,Hydroelectric Conventional,0,4535172,4535172
2002,NV,Natural Gas,24421320,0,24421320
2002,NV,Other Gases,89818,0,89818
2002,NV,Petroleum,50944,0,50944
2002,NV,Total,0,64177870,64177870
2002,NY,Coal,46478225,0,46478225
2002,NY,Hydroelectric Conventional,0,50095790,50095790
2002,NY,Natural Gas,76902384,0,76902384
2002,NY,Nuclear,0,79234982,79234982
2002,NY,Other,1630886,0,1630886
2002,NY,Other Biomass,2627648,0,2627648
2002,NY,Petroleum,23068219,0,23068219
2002,NY,Pumped Storage,0,-1842448,-1842448
2002,NY,Total,0,279183377,279183377
2002,NY,Wind,0,163252,163252
2002,NY,Wood and Wood Derived Fuels,824436,0,824436
2002,OH,Coal,265906131,0,265906131
2002,OH,Hydroelectric Conventional,0,976658,976658
2002,OH,Natural Gas,3533308,0,3533308
2002,OH,Nuclear,0,21729804,21729804
2002,OH,Other,497808,0,497808
2002,OH,Other Biomass,50488,0,50488
2002,OH,Other Gases,413130,0,413130
2002,OH,Petroleum,778238,0,778238
2002,OH,Total,0,294137699,294137699
2002,OH,Wood and Wood Derived Fuels,252134,0,252134
2002,OK,Coal,71929556,0,71929556
2002,OK,Hydroelectric Conventional,0,3975688,3975688
2002,OK,Natural Gas,42098078,0,42098078
2002,OK,Other Gases,141420,0,141420
2002,OK,Petroleum,99742,0,99742
2002,OK,Pumped Storage,0,-355736,-355736
2002,OK,Total,0,118366838,118366838
2002,OK,Wood and Wood Derived Fuels,478090,0,478090
2002,OR,Coal,7559368,0,7559368
2002,OR,Hydroelectric Conventional,0,68826334,68826334
2002,OR,Natural Gas,15625787,0,15625787
2002,OR,Other,76258,0,76258
2002,OR,Other Biomass,97092,0,97092
2002,OR,Petroleum,13408,0,13408
2002,OR,Total,0,94198737,94198737
2002,OR,Wind,0,752318,752318
2002,OR,Wood and Wood Derived Fuels,1248172,0,1248172
2002,PA,Coal,227812880,0,227812880
2002,PA,Hydroelectric Conventional,0,4421126,4421126
2002,PA,Natural Gas,13431074,0,13431074
2002,PA,Nuclear,0,152177860,152177860
2002,PA,Other,1389996,0,1389996
2002,PA,Other Biomass,2476874,0,2476874
2002,PA,Other Gases,1137450,0,1137450
2002,PA,Petroleum,5465890,0,5465890
2002,PA,Pumped Storage,0,-1315508,-1315508
2002,PA,Total,0,408645756,408645756
2002,PA,Wind,0,115536,115536
2002,PA,Wood and Wood Derived Fuels,1532578,0,1532578
2002,RI,Hydroelectric Conventional,0,7370,7370
2002,RI,Natural Gas,12620834,0,12620834
2002,RI,Other,1174756,0,1174756
2002,RI,Other Biomass,195504,0,195504
2002,RI,Petroleum,115066,0,115066
2002,RI,Total,0,14113530,14113530
2002,SC,Coal,73895444,0,73895444
2002,SC,Hydroelectric Conventional,0,2779502,2779502
2002,SC,Natural Gas,8996638,0,8996638
2002,SC,Nuclear,0,106651708,106651708
2002,SC,Other,0,0,0
2002,SC,Other Biomass,31044,0,31044
2002,SC,Other Gases,628,0,628
2002,SC,Petroleum,600674,0,600674
2002,SC,Pumped Storage,0,-2286432,-2286432
2002,SC,Total,0,193126996,193126996
2002,SC,Wood and Wood Derived Fuels,2457790,0,2457790
2002,SD,Coal,6543046,0,6543046
2002,SD,Hydroelectric Conventional,0,8707306,8707306
2002,SD,Natural Gas,171556,0,171556
2002,SD,Petroleum,9922,0,9922
2002,SD,Total,0,15443916,15443916
2002,SD,Wind,0,12086,12086
2002,TN,Coal,119411362,0,119411362
2002,TN,Hydroelectric Conventional,0,15947324,15947324
2002,TN,Natural Gas,939146,0,939146
2002,TN,Nuclear,0,55147850,55147850
2002,TN,Other,11100,0,11100
2002,TN,Other Biomass,90536,0,90536
2002,TN,Other Gases,23746,0,23746
2002,TN,Petroleum,539226,0,539226
2002,TN,Pumped Storage,0,-1391686,-1391686
2002,TN,Total,0,192228524,192228524
2002,TN,Wind,0,8136,8136
2002,TN,Wood and Wood Derived Fuels,1501784,0,1501784
2002,TX,Coal,283694480,0,283694480
2002,TX,Hydroelectric Conventional,0,2246984,2246984
2002,TX,Natural Gas,392866820,0,392866820
2002,TX,Nuclear,0,71236008,71236008
2002,TX,Other,3914372,0,3914372
2002,TX,Other Biomass,491375,0,491375
2002,TX,Other Gases,6105984,0,6105984
2002,TX,Petroleum,3241929,0,3241929
2002,TX,Total,0,771257084,771257084
2002,TX,Wind,0,5312208,5312208
2002,TX,Wood and Wood Derived Fuels,2146924,0,2146924
2002,UT,Coal,68975446,0,68975446
2002,UT,Geothermal,435302,0,435302
2002,UT,Hydroelectric Conventional,0,915464,915464
2002,UT,Natural Gas,2760362,0,2760362
2002,UT,Other,9854,0,9854
2002,UT,Other Biomass,12540,0,12540
2002,UT,Other Gases,0,0,0
2002,UT,Petroleum,107038,0,107038
2002,UT,Total,0,73216006,73216006
2002,VA,Coal,76164762,0,76164762
2002,VA,Hydroelectric Conventional,0,1736432,1736432
2002,VA,Natural Gas,8773854,0,8773854
2002,VA,Nuclear,0,54692326,54692326
2002,VA,Other,893845,0,893845
2002,VA,Other Biomass,1326701,0,1326701
2002,VA,Other Gases,0,0,0
2002,VA,Petroleum,7585209,0,7585209
2002,VA,Pumped Storage,0,-3977670,-3977670
2002,VA,Solar Thermal and Photovoltaic,0,0,0
2002,VA,Total,0,150011303,150011303
2002,VA,Wood and Wood Derived Fuels,2815844,0,2815844
2002,VT,Hydroelectric Conventional,0,2229844,2229844
2002,VT,Natural Gas,6550,0,6550
2002,VT,Nuclear,0,7925232,7925232
2002,VT,Petroleum,18812,0,18812
2002,VT,Total,0,10912380,10912380
2002,VT,Wind,0,20744,20744
2002,VT,Wood and Wood Derived Fuels,711198,0,711198
2002,WA,Coal,17321609,0,17321609
2002,WA,Hydroelectric Conventional,0,156333328,156333328
2002,WA,Natural Gas,9438622,0,9438622
2002,WA,Nuclear,0,18096950,18096950
2002,WA,Other,128438,0,128438
2002,WA,Other Biomass,362880,0,362880
2002,WA,Other Gases,625276,0,625276
2002,WA,Petroleum,146604,0,146604
2002,WA,Pumped Storage,0,-9064,-9064
2002,WA,Total,0,205530095,205530095
2002,WA,Wind,0,833162,833162
2002,WA,Wood and Wood Derived Fuels,2252290,0,2252290
2002,WI,Coal,79614968,0,79614968
2002,WI,Hydroelectric Conventional,0,5030034,5030034
2002,WI,Natural Gas,4152627,0,4152627
2002,WI,Nuclear,0,24897626,24897626
2002,WI,Other,291081,0,291081
2002,WI,Other Biomass,648931,0,648931
2002,WI,Petroleum,845355,0,845355
2002,WI,Total,0,116862876,116862876
2002,WI,Wind,0,92360,92360
2002,WI,Wood and Wood Derived Fuels,1289894,0,1289894
2002,WV,Coal,185902632,0,185902632
2002,WV,Hydroelectric Conventional,0,2131472,2131472
2002,WV,Natural Gas,482281,0,482281
2002,WV,Other,33538,0,33538
2002,WV,Other Biomass,11062,0,11062
2002,WV,Other Gases,349196,0,349196
2002,WV,Petroleum,595174,0,595174
2002,WV,Total,0,189523503,189523503
2002,WV,Wind,0,18046,18046
2002,WV,Wood and Wood Derived Fuels,102,0,102
2002,WY,Coal,83846322,0,83846322
2002,WY,Hydroelectric Conventional,0,1167230,1167230
2002,WY,Natural Gas,1426160,0,1426160
2002,WY,Other,153098,0,153098
2002,WY,Petroleum,80208,0,80208
2002,WY,Total,0,87567678,87567678
2002,WY,Wind,0,894660,894660
2003,WY,Coal,0,0,0
2003,WY,Natural Gas,0,0,0
2003,WY,Petroleum,0,0,0
2003,AK,Coal,1099328,0,1099328
2003,AK,Hydroelectric Conventional,0,3165072,3165072
2003,AK,Natural Gas,6708964,0,6708964
2003,AK,Other Biomass,10038,0,10038
2003,AK,Petroleum,1692548,0,1692548
2003,AK,Total,0,12677465,12677465
2003,AK,Wood and Wood Derived Fuels,1516,0,1516
2003,AL,Coal,153392782,0,153392782
2003,AL,Hydroelectric Conventional,0,25329734,25329734
2003,AL,Natural Gas,24487196,0,24487196
2003,AL,Nuclear,0,63353906,63353906
2003,AL,Other,51086,0,51086
2003,AL,Other Biomass,47950,0,47950
2003,AL,Other Gases,340736,0,340736
2003,AL,Petroleum,673288,0,673288
2003,AL,Total,0,274974444,274974444
2003,AL,Wood and Wood Derived Fuels,7297766,0,7297766
2003,AR,Coal,47008332,0,47008332
2003,AR,Hydroelectric Conventional,0,5309236,5309236
2003,AR,Natural Gas,14601721,0,14601721
2003,AR,Nuclear,0,29378832,29378832
2003,AR,Other,218322,0,218322
2003,AR,Other Biomass,189543,0,189543
2003,AR,Petroleum,577812,0,577812
2003,AR,Pumped Storage,0,20170,20170
2003,AR,Total,0,100802203,100802203
2003,AR,Wood and Wood Derived Fuels,3498234,0,3498234
2003,AZ,Coal,76182818,0,76182818
2003,AZ,Hydroelectric Conventional,0,14149968,14149968
2003,AZ,Natural Gas,37865282,0,37865282
2003,AZ,Nuclear,0,57162106,57162106
2003,AZ,Other,2677190,0,2677190
2003,AZ,Other Biomass,89748,0,89748
2003,AZ,Petroleum,97353,0,97353
2003,AZ,Pumped Storage,0,567180,567180
2003,AZ,Solar Thermal and Photovoltaic,0,790,790
2003,AZ,Total,0,188792436,188792436
2003,CA,Coal,4652610,0,4652610
2003,CA,Geothermal,25963526,0,25963526
2003,CA,Hydroelectric Conventional,0,72741407,72741407
2003,CA,Natural Gas,182864362,0,182864362
2003,CA,Nuclear,0,71187578,71187578
2003,CA,Other,562990,0,562990
2003,CA,Other Biomass,4508562,0,4508562
2003,CA,Other Gases,3518030,0,3518030
2003,CA,Petroleum,4784497,0,4784497
2003,CA,Pumped Storage,0,-1824626,-1824626
2003,CA,Solar Thermal and Photovoltaic,0,1067212,1067212
2003,CA,Total,0,385577085,385577085
2003,CA,Wind,0,7790862,7790862
2003,CA,Wood and Wood Derived Fuels,7760074,0,7760074
2003,CO,Coal,72231246,0,72231246
2003,CO,Hydroelectric Conventional,0,2524394,2524394
2003,CO,Natural Gas,18452066,0,18452066
2003,CO,Other Biomass,62940,0,62940
2003,CO,Other Gases,8002,0,8002
2003,CO,Petroleum,67988,0,67988
2003,CO,Pumped Storage,0,-407280,-407280
2003,CO,Total,0,93233573,93233573
2003,CO,Wind,0,294218,294218
2003,CO,Wood and Wood Derived Fuels,0,0,0
2003,CT,Coal,8400594,0,8400594
2003,CT,Hydroelectric Conventional,0,1128832,1128832
2003,CT,Natural Gas,10123226,0,10123226
2003,CT,Nuclear,0,32156190,32156190
2003,CT,Other,1584236,0,1584236
2003,CT,Other Biomass,1571722,0,1571722
2003,CT,Other Gases,0,0,0
2003,CT,Petroleum,4125337,0,4125337
2003,CT,Pumped Storage,0,-36,-36
2003,CT,Total,0,59090100,59090100
2003,CT,Wood and Wood Derived Fuels,0,0,0
2003,DC,Petroleum,148288,0,148288
2003,DC,Total,0,148288,148288
2003,DE,Coal,8052992,0,8052992
2003,DE,Natural Gas,2927560,0,2927560
2003,DE,Other Gases,370294,0,370294
2003,DE,Petroleum,3433728,0,3433728
2003,DE,Total,0,14784574,14784574
2003,FL,Coal,135349160,0,135349160
2003,FL,Hydroelectric Conventional,0,525334,525334
2003,FL,Natural Gas,136586839,0,136586839
2003,FL,Nuclear,0,61958962,61958962
2003,FL,Other,7421400,0,7421400
2003,FL,Other Biomass,4527389,0,4527389
2003,FL,Other Gases,21010,0,21010
2003,FL,Petroleum,74409139,0,74409139
2003,FL,Total,0,425220023,425220023
2003,FL,Wood and Wood Derived Fuels,4420789,0,4420789
2003,GA,Coal,157276978,0,157276978
2003,GA,Hydroelectric Conventional,0,8280540,8280540
2003,GA,Natural Gas,8553982,0,8553982
2003,GA,Nuclear,0,66513298,66513298
2003,GA,Other,66392,0,66392
2003,GA,Other Biomass,267842,0,267842
2003,GA,Petroleum,2388118,0,2388118
2003,GA,Pumped Storage,0,-1272186,-1272186
2003,GA,Total,0,248153668,248153668
2003,GA,Wood and Wood Derived Fuels,6078706,0,6078706
2003,HI,Coal,3288274,0,3288274
2003,HI,Geothermal,356584,0,356584
2003,HI,Hydroelectric Conventional,0,181010,181010
2003,HI,Other,343794,0,343794
2003,HI,Other Biomass,694334,0,694334
2003,HI,Other Gases,80502,0,80502
2003,HI,Petroleum,17005100,0,17005100
2003,HI,Total,0,21952743,21952743
2003,HI,Wind,0,3144,3144
2003,IA,Coal,71639890,0,71639890
2003,IA,Hydroelectric Conventional,0,1577186,1577186
2003,IA,Natural Gas,625792,0,625792
2003,IA,Nuclear,0,7975314,7975314
2003,IA,Other,19250,0,19250
2003,IA,Other Biomass,228340,0,228340
2003,IA,Petroleum,202671,0,202671
2003,IA,Total,0,84232384,84232384
2003,IA,Wind,0,1963940,1963940
2003,ID,Coal,180580,0,180580
2003,ID,Hydroelectric Conventional,0,16708068,16708068
2003,ID,Natural Gas,2749640,0,2749640
2003,ID,Other,125444,0,125444
2003,ID,Petroleum,232,0,232
2003,ID,Total,0,20845871,20845871
2003,ID,Wood and Wood Derived Fuels,1081906,0,1081906
2003,IL,Coal,175962698,0,175962698
2003,IL,Hydroelectric Conventional,0,277000,277000
2003,IL,Natural Gas,7804925,0,7804925
2003,IL,Nuclear,0,189466072,189466072
2003,IL,Other,312836,0,312836
2003,IL,Other Biomass,1601854,0,1601854
2003,IL,Other Gases,407254,0,407254
2003,IL,Petroleum,2241834,0,2241834
2003,IL,Total,0,378110520,378110520
2003,IL,Wind,0,36048,36048
2003,IN,Coal,235512568,0,235512568
2003,IN,Hydroelectric Conventional,0,847906,847906
2003,IN,Natural Gas,6098870,0,6098870
2003,IN,Other,983728,0,983728
2003,IN,Other Biomass,238276,0,238276
2003,IN,Other Gases,5184514,0,5184514
2003,IN,Petroleum,910574,0,910574
2003,IN,Total,0,249776435,249776435
2003,KS,Coal,70219232,0,70219232
2003,KS,Hydroelectric Conventional,0,24870,24870
2003,KS,Natural Gas,2451540,0,2451540
2003,KS,Nuclear,0,17779334,17779334
2003,KS,Petroleum,1928264,0,1928264
2003,KS,Total,0,93135121,93135121
2003,KS,Wind,0,731878,731878
2003,KY,Coal,168121080,0,168121080
2003,KY,Hydroelectric Conventional,0,7896104,7896104
2003,KY,Natural Gas,888810,0,888810
2003,KY,Other,43344,0,43344
2003,KY,Other Biomass,1528,0,1528
2003,KY,Other Gases,0,0,0
2003,KY,Petroleum,5889822,0,5889822
2003,KY,Total,0,183437640,183437640
2003,KY,Wood and Wood Derived Fuels,596952,0,596952
2003,LA,Coal,45777860,0,45777860
2003,LA,Hydroelectric Conventional,0,1783982,1783982
2003,LA,Natural Gas,90868396,0,90868396
2003,LA,Nuclear,0,32252644,32252644
2003,LA,Other,1680234,0,1680234
2003,LA,Other Biomass,129322,0,129322
2003,LA,Other Gases,5374460,0,5374460
2003,LA,Petroleum,5875896,0,5875896
2003,LA,Total,0,189770080,189770080
2003,LA,Wood and Wood Derived Fuels,6027284,0,6027284
2003,MA,Coal,21792980,0,21792980
2003,MA,Hydroelectric Conventional,0,2150364,2150364
2003,MA,Natural Gas,44847862,0,44847862
2003,MA,Nuclear,0,9955910,9955910
2003,MA,Other,1620468,0,1620468
2003,MA,Other Biomass,2267178,0,2267178
2003,MA,Petroleum,14918076,0,14918076
2003,MA,Pumped Storage,0,-1021858,-1021858
2003,MA,Total,0,96770048,96770048
2003,MA,Wood and Wood Derived Fuels,239068,0,239068
2003,MD,Coal,59878172,0,59878172
2003,MD,Hydroelectric Conventional,0,5293968,5293968
2003,MD,Natural Gas,2391285,0,2391285
2003,MD,Nuclear,0,27381426,27381426
2003,MD,Other,556448,0,556448
2003,MD,Other Biomass,741621,0,741621
2003,MD,Other Gases,650710,0,650710
2003,MD,Petroleum,7144366,0,7144366
2003,MD,Total,0,104488474,104488474
2003,MD,Wood and Wood Derived Fuels,450480,0,450480
2003,ME,Coal,753064,0,753064
2003,ME,Hydroelectric Conventional,0,6345245,6345245
2003,ME,Natural Gas,18877408,0,18877408
2003,ME,Other,956368,0,956368
2003,ME,Other Biomass,596211,0,596211
2003,ME,Other Gases,68,0,68
2003,ME,Petroleum,3839097,0,3839097
2003,ME,Total,0,37943271,37943271
2003,ME,Wood and Wood Derived Fuels,6575810,0,6575810
2003,MI,Coal,135554966,0,135554966
2003,MI,Hydroelectric Conventional,0,2771647,2771647
2003,MI,Natural Gas,22749088,0,22749088
2003,MI,Nuclear,0,55907126,55907126
2003,MI,Other,618224,0,618224
2003,MI,Other Biomass,1454628,0,1454628
2003,MI,Other Gases,4386,0,4386
2003,MI,Petroleum,2127786,0,2127786
2003,MI,Pumped Storage,0,-2034492,-2034492
2003,MI,Total,0,222694119,222694119
2003,MI,Wind,0,5320,5320
2003,MI,Wood and Wood Derived Fuels,3535442,0,3535442
2003,MN,Coal,71311058,0,71311058
2003,MN,Hydroelectric Conventional,0,1629146,1629146
2003,MN,Natural Gas,3688872,0,3688872
2003,MN,Nuclear,0,26827656,26827656
2003,MN,Other,657870,0,657870
2003,MN,Other Biomass,972632,0,972632
2003,MN,Petroleum,1746129,0,1746129
2003,MN,Total,0,110101991,110101991
2003,MN,Wind,0,1955520,1955520
2003,MN,Wood and Wood Derived Fuels,1313110,0,1313110
2003,MO,Coal,148423568,0,148423568
2003,MO,Hydroelectric Conventional,0,1304954,1304954
2003,MO,Natural Gas,5248700,0,5248700
2003,MO,Nuclear,0,19399178,19399178
2003,MO,Other,247672,0,247672
2003,MO,Other Biomass,16594,0,16594
2003,MO,Other Gases,3304,0,3304
2003,MO,Petroleum,313828,0,313828
2003,MO,Pumped Storage,0,-507982,-507982
2003,MO,Total,0,174450174,174450174
2003,MO,Wood and Wood Derived Fuels,358,0,358
2003,MS,Coal,34165208,0,34165208
2003,MS,Natural Gas,18954466,0,18954466
2003,MS,Nuclear,0,21804912,21804912
2003,MS,Other,312,0,312
2003,MS,Other Biomass,14158,0,14158
2003,MS,Other Gases,63598,0,63598
2003,MS,Petroleum,3263711,0,3263711
2003,MS,Total,0,80296556,80296556
2003,MS,Wood and Wood Derived Fuels,2030192,0,2030192
2003,MT,Coal,34097270,0,34097270
2003,MT,Hydroelectric Conventional,0,17403544,17403544
2003,MT,Natural Gas,50936,0,50936
2003,MT,Other Gases,39040,0,39040
2003,MT,Petroleum,804328,0,804328
2003,MT,Total,0,52537453,52537453
2003,MT,Wood and Wood Derived Fuels,142336,0,142336
2003,NC,Coal,149552462,0,149552462
2003,NC,Hydroelectric Conventional,0,14401887,14401887
2003,NC,Natural Gas,3160732,0,3160732
2003,NC,Nuclear,0,81813800,81813800
2003,NC,Other,478355,0,478355
2003,NC,Other Biomass,228107,0,228107
2003,NC,Other Gases,34,0,34
2003,NC,Petroleum,1567390,0,1567390
2003,NC,Pumped Storage,0,238546,238546
2003,NC,Total,0,255164638,255164638
2003,NC,Wood and Wood Derived Fuels,3723326,0,3723326
2003,ND,Coal,58854622,0,58854622
2003,ND,Hydroelectric Conventional,0,3447808,3447808
2003,ND,Natural Gas,18892,0,18892
2003,ND,Other Biomass,1204,0,1204
2003,ND,Other Gases,100192,0,100192
2003,ND,Petroleum,103784,0,103784
2003,ND,Total,0,62644258,62644258
2003,ND,Wind,0,117756,117756
2003,NE,Coal,41908346,0,41908346
2003,NE,Hydroelectric Conventional,0,1960220,1960220
2003,NE,Natural Gas,762156,0,762156
2003,NE,Nuclear,0,15993804,15993804
2003,NE,Other,0,0,0
2003,NE,Other Biomass,112884,0,112884
2003,NE,Other Gases,412,0,412
2003,NE,Petroleum,97704,0,97704
2003,NE,Total,0,60911968,60911968
2003,NE,Wind,0,76442,76442
2003,NH,Coal,7846606,0,7846606
2003,NH,Hydroelectric Conventional,0,2662538,2662538
2003,NH,Natural Gas,8330930,0,8330930
2003,NH,Nuclear,0,18552576,18552576
2003,NH,Other,120720,0,120720
2003,NH,Other Biomass,317040,0,317040
2003,NH,Petroleum,4089053,0,4089053
2003,NH,Total,0,43194214,43194214
2003,NH,Wood and Wood Derived Fuels,1274752,0,1274752
2003,NJ,Coal,19579126,0,19579126
2003,NJ,Hydroelectric Conventional,0,77782,77782
2003,NJ,Natural Gas,29551154,0,29551154
2003,NJ,Nuclear,0,59418402,59418402
2003,NJ,Other,1004608,0,1004608
2003,NJ,Other Biomass,1813542,0,1813542
2003,NJ,Other Gases,510748,0,510748
2003,NJ,Petroleum,3083105,0,3083105
2003,NJ,Pumped Storage,0,-239764,-239764
2003,NJ,Total,0,114798702,114798702
2003,NM,Coal,57625688,0,57625688
2003,NM,Hydroelectric Conventional,0,341398,341398
2003,NM,Natural Gas,7037410,0,7037410
2003,NM,Other Biomass,0,0,0
2003,NM,Petroleum,101338,0,101338
2003,NM,Total,0,65471305,65471305
2003,NM,Wind,0,365470,365470
2003,NV,Coal,34171918,0,34171918
2003,NV,Geothermal,2131422,0,2131422
2003,NV,Hydroelectric Conventional,0,3513410,3513410
2003,NV,Natural Gas,26505558,0,26505558
2003,NV,Other Gases,33882,0,33882
2003,NV,Petroleum,33586,0,33586
2003,NV,Total,0,66389776,66389776
2003,NY,Coal,47162134,0,47162134
2003,NY,Hydroelectric Conventional,0,48537320,48537320
2003,NY,Natural Gas,56312696,0,56312696
2003,NY,Nuclear,0,81358410,81358410
2003,NY,Other,1685485,0,1685485
2003,NY,Other Biomass,2565445,0,2565445
2003,NY,Petroleum,38583199,0,38583199
2003,NY,Pumped Storage,0,-1823612,-1823612
2003,NY,Total,0,275286632,275286632
2003,NY,Wind,0,82402,82402
2003,NY,Wood and Wood Derived Fuels,823152,0,823152
2003,OH,Coal,269538274,0,269538274
2003,OH,Hydroelectric Conventional,0,1021670,1021670
2003,OH,Natural Gas,3587167,0,3587167
2003,OH,Nuclear,0,16950032,16950032
2003,OH,Other,52326,0,52326
2003,OH,Other Biomass,66600,0,66600
2003,OH,Other Gases,425046,0,425046
2003,OH,Petroleum,820307,0,820307
2003,OH,Total,0,293276256,293276256
2003,OH,Wood and Wood Derived Fuels,814834,0,814834
2003,OK,Coal,73352652,0,73352652
2003,OK,Hydroelectric Conventional,0,3596824,3596824
2003,OK,Natural Gas,43645392,0,43645392
2003,OK,Other,14796,0,14796
2003,OK,Other Biomass,0,0,0
2003,OK,Other Gases,90816,0,90816
2003,OK,Petroleum,322420,0,322420
2003,OK,Pumped Storage,0,-412374,-412374
2003,OK,Total,0,121253712,121253712
2003,OK,Wind,0,108940,108940
2003,OK,Wood and Wood Derived Fuels,534246,0,534246
2003,OR,Coal,8609696,0,8609696
2003,OR,Hydroelectric Conventional,0,66500664,66500664
2003,OR,Natural Gas,20487392,0,20487392
2003,OR,Other,81138,0,81138
2003,OR,Other Biomass,170132,0,170132
2003,OR,Petroleum,88192,0,88192
2003,OR,Total,0,97932278,97932278
2003,OR,Wind,0,887234,887234
2003,OR,Wood and Wood Derived Fuels,1107828,0,1107828
2003,PA,Coal,232019748,0,232019748
2003,PA,Hydroelectric Conventional,0,6692534,6692534
2003,PA,Natural Gas,11037073,0,11037073
2003,PA,Nuclear,0,148721724,148721724
2003,PA,Other,1423676,0,1423676
2003,PA,Other Biomass,2501336,0,2501336
2003,PA,Other Gases,1016352,0,1016352
2003,PA,Petroleum,9070673,0,9070673
2003,PA,Pumped Storage,0,-1477988,-1477988
2003,PA,Total,0,412699027,412699027
2003,PA,Wind,0,223042,223042
2003,PA,Wood and Wood Derived Fuels,1470858,0,1470858
2003,RI,Hydroelectric Conventional,0,12042,12042
2003,RI,Natural Gas,10909993,0,10909993
2003,RI,Other Biomass,203536,0,203536
2003,RI,Petroleum,116718,0,116718
2003,RI,Total,0,11242289,11242289
2003,SC,Coal,74864046,0,74864046
2003,SC,Hydroelectric Conventional,0,7330852,7330852
2003,SC,Natural Gas,3325564,0,3325564
2003,SC,Nuclear,0,100835380,100835380
2003,SC,Other,97354,0,97354
2003,SC,Other Biomass,103374,0,103374
2003,SC,Other Gases,146,0,146
2003,SC,Petroleum,913742,0,913742
2003,SC,Pumped Storage,0,-2413626,-2413626
2003,SC,Total,0,187545355,187545355
2003,SC,Wood and Wood Derived Fuels,2488524,0,2488524
2003,SD,Coal,6862406,0,6862406
2003,SD,Hydroelectric Conventional,0,8552606,8552606
2003,SD,Natural Gas,352048,0,352048
2003,SD,Petroleum,32116,0,32116
2003,SD,Total,0,15887674,15887674
2003,SD,Wind,0,88498,88498
2003,TN,Coal,109842595,0,109842595
2003,TN,Hydroelectric Conventional,0,24007292,24007292
2003,TN,Natural Gas,1253973,0,1253973
2003,TN,Nuclear,0,48305160,48305160
2003,TN,Other,14902,0,14902
2003,TN,Other Biomass,117842,0,117842
2003,TN,Other Gases,5668,0,5668
2003,TN,Petroleum,811620,0,811620
2003,TN,Pumped Storage,0,-1457298,-1457298
2003,TN,Total,0,184443581,184443581
2003,TN,Wind,0,7866,7866
2003,TN,Wood and Wood Derived Fuels,1533964,0,1533964
2003,TX,Coal,293979020,0,293979020
2003,TX,Hydroelectric Conventional,0,1793078,1793078
2003,TX,Natural Gas,369822700,0,369822700
2003,TX,Nuclear,0,66874968,66874968
2003,TX,Other,968640,0,968640
2003,TX,Other Biomass,719448,0,719448
2003,TX,Other Gases,11998979,0,11998979
2003,TX,Petroleum,5030510,0,5030510
2003,TX,Total,0,758399370,758399370
2003,TX,Wind,0,5139706,5139706
2003,TX,Wood and Wood Derived Fuels,2072320,0,2072320
2003,UT,Coal,71957296,0,71957296
2003,UT,Geothermal,396930,0,396930
2003,UT,Hydroelectric Conventional,0,842678,842678
2003,UT,Natural Gas,2766214,0,2766214
2003,UT,Other,8316,0,8316
2003,UT,Other Biomass,10166,0,10166
2003,UT,Other Gases,0,0,0
2003,UT,Petroleum,65732,0,65732
2003,UT,Total,0,76047332,76047332
2003,VA,Coal,74186662,0,74186662
2003,VA,Hydroelectric Conventional,0,3563138,3563138
2003,VA,Natural Gas,9238131,0,9238131
2003,VA,Nuclear,0,49632044,49632044
2003,VA,Other,905873,0,905873
2003,VA,Other Biomass,1347629,0,1347629
2003,VA,Other Gases,5918,0,5918
2003,VA,Petroleum,11560672,0,11560672
2003,VA,Pumped Storage,0,-2996318,-2996318
2003,VA,Total,0,150618840,150618840
2003,VA,Wood and Wood Derived Fuels,3175090,0,3175090
2003,VT,Hydroelectric Conventional,0,2308076,2308076
2003,VT,Natural Gas,4058,0,4058
2003,VT,Nuclear,0,8888304,8888304
2003,VT,Petroleum,45214,0,45214
2003,VT,Total,0,12055924,12055924
2003,VT,Wind,0,21658,21658
2003,VT,Wood and Wood Derived Fuels,788614,0,788614
2003,WA,Coal,22179592,0,22179592
2003,WA,Hydroelectric Conventional,0,143513566,143513566
2003,WA,Natural Gas,14165210,0,14165210
2003,WA,Nuclear,0,15229416,15229416
2003,WA,Other,112014,0,112014
2003,WA,Other Biomass,363796,0,363796
2003,WA,Other Gases,606376,0,606376
2003,WA,Petroleum,133183,0,133183
2003,WA,Pumped Storage,0,-6586,-6586
2003,WA,Total,0,200189382,200189382
2003,WA,Wind,0,1207348,1207348
2003,WA,Wood and Wood Derived Fuels,2685466,0,2685466
2003,WI,Coal,83434432,0,83434432
2003,WI,Hydroelectric Conventional,0,3686590,3686590
2003,WI,Natural Gas,4956781,0,4956781
2003,WI,Nuclear,0,24430926,24430926
2003,WI,Other,339096,0,339096
2003,WI,Other Biomass,741402,0,741402
2003,WI,Petroleum,945575,0,945575
2003,WI,Total,0,120244849,120244849
2003,WI,Wind,0,195160,195160
2003,WI,Wood and Wood Derived Fuels,1514886,0,1514886
2003,WV,Coal,184937966,0,184937966
2003,WV,Hydroelectric Conventional,0,2712062,2712062
2003,WV,Natural Gas,555674,0,555674
2003,WV,Other,34104,0,34104
2003,WV,Other Biomass,8102,0,8102
2003,WV,Other Gases,339564,0,339564
2003,WV,Petroleum,495795,0,495795
2003,WV,Total,0,189423108,189423108
2003,WV,Wind,0,339524,339524
2003,WV,Wood and Wood Derived Fuels,314,0,314
2003,WY,Coal,84682904,0,84682904
2003,WY,Hydroelectric Conventional,0,1187110,1187110
2003,WY,Natural Gas,560392,0,560392
2003,WY,Petroleum,89842,0,89842
2003,WY,Total,0,87253204,87253204
2003,WY,Wind,0,732956,732956
2004,AK,Coal,1297960,0,1297960
2004,AK,Hydroelectric Conventional,0,2996040,2996040
2004,AK,Natural Gas,7246866,0,7246866
2004,AK,Other Biomass,17656,0,17656
2004,AK,Petroleum,1494136,0,1494136
2004,AK,Total,0,13053434,13053434
2004,AK,Wood and Wood Derived Fuels,778,0,778
2004,AL,Coal,149663248,0,149663248
2004,AL,Hydroelectric Conventional,0,21252442,21252442
2004,AL,Natural Gas,31954038,0,31954038
2004,AL,Nuclear,0,63271578,63271578
2004,AL,Other,55834,0,55834
2004,AL,Other Biomass,45754,0,45754
2004,AL,Other Gases,363884,0,363884
2004,AL,Petroleum,590050,0,590050
2004,AL,Total,0,274709542,274709542
2004,AL,Wood and Wood Derived Fuels,7512712,0,7512712
2004,AR,Coal,50707126,0,50707126
2004,AR,Hydroelectric Conventional,0,7286878,7286878
2004,AR,Natural Gas,10137528,0,10137528
2004,AR,Nuclear,0,30899702,30899702
2004,AR,Other,75900,0,75900
2004,AR,Other Biomass,65218,0,65218
2004,AR,Petroleum,1077882,0,1077882
2004,AR,Pumped Storage,0,49490,49490
2004,AR,Total,0,103855265,103855265
2004,AR,Wood and Wood Derived Fuels,3555540,0,3555540
2004,AZ,Coal,79621112,0,79621112
2004,AZ,Hydroelectric Conventional,0,13946294,13946294
2004,AZ,Natural Gas,56529886,0,56529886
2004,AZ,Nuclear,0,56225218,56225218
2004,AZ,Other,2735100,0,2735100
2004,AZ,Other Biomass,87996,0,87996
2004,AZ,Petroleum,81032,0,81032
2004,AZ,Pumped Storage,0,-106880,-106880
2004,AZ,Solar Thermal and Photovoltaic,0,8530,8530
2004,AZ,Total,0,209128286,209128286
2004,CA,Coal,4475617,0,4475617
2004,CA,Geothermal,26210612,0,26210612
2004,CA,Hydroelectric Conventional,0,68281858,68281858
2004,CA,Natural Gas,200444465,0,200444465
2004,CA,Nuclear,0,60535774,60535774
2004,CA,Other,857134,0,857134
2004,CA,Other Biomass,4323844,0,4323844
2004,CA,Other Gases,4131930,0,4131930
2004,CA,Petroleum,4525795,0,4525795
2004,CA,Pumped Storage,0,-1633662,-1633662
2004,CA,Solar Thermal and Photovoltaic,0,1141780,1141780
2004,CA,Total,0,389560709,389560709
2004,CA,Wind,0,8611750,8611750
2004,CA,Wood and Wood Derived Fuels,7653813,0,7653813
2004,CO,Coal,71696780,0,71696780
2004,CO,Hydroelectric Conventional,0,2389330,2389330
2004,CO,Natural Gas,21494992,0,21494992
2004,CO,Other Biomass,69786,0,69786
2004,CO,Other Gases,3506,0,3506
2004,CO,Petroleum,27735,0,27735
2004,CO,Pumped Storage,0,-383602,-383602
2004,CO,Total,0,95738985,95738985
2004,CO,Wind,0,440282,440282
2004,CO,Wood and Wood Derived Fuels,174,0,174
2004,CT,Coal,8510144,0,8510144
2004,CT,Hydroelectric Conventional,0,925224,925224
2004,CT,Natural Gas,16215612,0,16215612
2004,CT,Nuclear,0,33078194,33078194
2004,CT,Other,1526348,0,1526348
2004,CT,Other Biomass,1504724,0,1504724
2004,CT,Other Gases,0,0,0
2004,CT,Petroleum,3480224,0,3480224
2004,CT,Pumped Storage,0,15430,15430
2004,CT,Total,0,65266814,65266814
2004,CT,Wood and Wood Derived Fuels,10914,0,10914
2004,DC,Petroleum,72974,0,72974
2004,DC,Total,0,72974,72974
2004,DE,Coal,9487670,0,9487670
2004,DE,Natural Gas,3436838,0,3436838
2004,DE,Other Gases,579440,0,579440
2004,DE,Petroleum,2207156,0,2207156
2004,DE,Total,0,15711106,15711106
2004,FL,Coal,129723549,0,129723549
2004,FL,Hydroelectric Conventional,0,530516,530516
2004,FL,Natural Gas,153153940,0,153153940
2004,FL,Nuclear,0,62431152,62431152
2004,FL,Other,6853188,0,6853188
2004,FL,Other Biomass,4570495,0,4570495
2004,FL,Other Gases,29464,0,29464
2004,FL,Petroleum,74510904,0,74510904
2004,FL,Total,0,436235856,436235856
2004,FL,Wood and Wood Derived Fuels,4432648,0,4432648
2004,GA,Coal,159885926,0,159885926
2004,GA,Hydroelectric Conventional,0,7384792,7384792
2004,GA,Natural Gas,12259304,0,12259304
2004,GA,Nuclear,0,67495410,67495410
2004,GA,Other,79154,0,79154
2004,GA,Other Biomass,166928,0,166928
2004,GA,Petroleum,1893056,0,1893056
2004,GA,Pumped Storage,0,-1755692,-1755692
2004,GA,Total,0,253625430,253625430
2004,GA,Wood and Wood Derived Fuels,6216550,0,6216550
2004,HI,Coal,3207502,0,3207502
2004,HI,Geothermal,426576,0,426576
2004,HI,Hydroelectric Conventional,0,187802,187802
2004,HI,Other,341063,0,341063
2004,HI,Other Biomass,657664,0,657664
2004,HI,Other Gases,95816,0,95816
2004,HI,Petroleum,17889393,0,17889393
2004,HI,Total,0,22820806,22820806
2004,HI,Wind,0,14990,14990
2004,IA,Coal,70544393,0,70544393
2004,IA,Hydroelectric Conventional,0,1891918,1891918
2004,IA,Natural Gas,1649412,0,1649412
2004,IA,Nuclear,0,9857896,9857896
2004,IA,Other,23766,0,23766
2004,IA,Other Biomass,211852,0,211852
2004,IA,Petroleum,217240,0,217240
2004,IA,Total,0,86496378,86496378
2004,IA,Wind,0,2099904,2099904
2004,ID,Coal,198406,0,198406
2004,ID,Hydroelectric Conventional,0,16923310,16923310
2004,ID,Natural Gas,3407646,0,3407646
2004,ID,Other,75884,0,75884
2004,ID,Petroleum,272,0,272
2004,ID,Total,0,21726078,21726078
2004,ID,Wood and Wood Derived Fuels,1120560,0,1120560
2004,IL,Coal,188803255,0,188803255
2004,IL,Hydroelectric Conventional,0,307058,307058
2004,IL,Natural Gas,6786624,0,6786624
2004,IL,Nuclear,0,184094646,184094646
2004,IL,Other,263280,0,263280
2004,IL,Other Biomass,1487853,0,1487853
2004,IL,Other Gases,492016,0,492016
2004,IL,Petroleum,1524680,0,1524680
2004,IL,Total,0,383915557,383915557
2004,IL,Wind,0,156146,156146
2004,IN,Coal,241341864,0,241341864
2004,IN,Hydroelectric Conventional,0,887442,887442
2004,IN,Natural Gas,4876453,0,4876453
2004,IN,Other,1037148,0,1037148
2004,IN,Other Biomass,274740,0,274740
2004,IN,Other Gases,6272634,0,6272634
2004,IN,Petroleum,850514,0,850514
2004,IN,Total,0,255540793,255540793
2004,KS,Coal,69186692,0,69186692
2004,KS,Hydroelectric Conventional,0,25094,25094
2004,KS,Natural Gas,1663268,0,1663268
2004,KS,Nuclear,0,20265472,20265472
2004,KS,Petroleum,1707526,0,1707526
2004,KS,Total,0,93565318,93565318
2004,KS,Wind,0,717264,717264
2004,KY,Coal,172241022,0,172241022
2004,KY,Hydroelectric Conventional,0,7560502,7560502
2004,KY,Natural Gas,1159680,0,1159680
2004,KY,Other,31056,0,31056
2004,KY,Other Biomass,123798,0,123798
2004,KY,Other Gases,3402,0,3402
2004,KY,Petroleum,7242198,0,7242198
2004,KY,Total,0,189059894,189059894
2004,KY,Wood and Wood Derived Fuels,698238,0,698238
2004,LA,Coal,47315622,0,47315622
2004,LA,Hydroelectric Conventional,0,2197650,2197650
2004,LA,Natural Gas,92339075,0,92339075
2004,LA,Nuclear,0,34159962,34159962
2004,LA,Other,1527180,0,1527180
2004,LA,Other Biomass,153142,0,153142
2004,LA,Other Gases,5065715,0,5065715
2004,LA,Petroleum,7806630,0,7806630
2004,LA,Total,0,196344618,196344618
2004,LA,Wood and Wood Derived Fuels,5779640,0,5779640
2004,MA,Coal,21052724,0,21052724
2004,MA,Hydroelectric Conventional,0,1996562,1996562
2004,MA,Natural Gas,41943442,0,41943442
2004,MA,Nuclear,0,11877200,11877200
2004,MA,Other,1601572,0,1601572
2004,MA,Other Biomass,2231129,0,2231129
2004,MA,Petroleum,15066315,0,15066315
2004,MA,Pumped Storage,0,-996652,-996652
2004,MA,Total,0,95000965,95000965
2004,MA,Wood and Wood Derived Fuels,228672,0,228672
2004,MD,Coal,58390916,0,58390916
2004,MD,Hydroelectric Conventional,0,5015042,5015042
2004,MD,Natural Gas,2366602,0,2366602
2004,MD,Nuclear,0,29160520,29160520
2004,MD,Other,577232,0,577232
2004,MD,Other Biomass,793647,0,793647
2004,MD,Other Gases,823130,0,823130
2004,MD,Petroleum,6593683,0,6593683
2004,MD,Total,0,104105540,104105540
2004,MD,Wood and Wood Derived Fuels,384768,0,384768
2004,ME,Coal,718820,0,718820
2004,ME,Hydroelectric Conventional,0,6860498,6860498
2004,ME,Natural Gas,19664374,0,19664374
2004,ME,Other,1134103,0,1134103
2004,ME,Other Biomass,822160,0,822160
2004,ME,Other Gases,76,0,76
2004,ME,Petroleum,2623826,0,2623826
2004,ME,Total,0,38197771,38197771
2004,ME,Wood and Wood Derived Fuels,6373914,0,6373914
2004,MI,Coal,137212038,0,137212038
2004,MI,Hydroelectric Conventional,0,3079168,3079168
2004,MI,Natural Gas,29095406,0,29095406
2004,MI,Nuclear,0,61123922,61123922
2004,MI,Other,582762,0,582762
2004,MI,Other Biomass,1379872,0,1379872
2004,MI,Other Gases,1197494,0,1197494
2004,MI,Petroleum,1792818,0,1792818
2004,MI,Pumped Storage,0,-2225968,-2225968
2004,MI,Total,0,236974539,236974539
2004,MI,Wind,0,3750,3750
2004,MI,Wood and Wood Derived Fuels,3733276,0,3733276
2004,MN,Coal,68000416,0,68000416
2004,MN,Hydroelectric Conventional,0,1476622,1476622
2004,MN,Natural Gas,2915168,0,2915168
2004,MN,Nuclear,0,26591004,26591004
2004,MN,Other,584043,0,584043
2004,MN,Other Biomass,664555,0,664555
2004,MN,Petroleum,1566901,0,1566901
2004,MN,Total,0,104728254,104728254
2004,MN,Wind,0,1624742,1624742
2004,MN,Wood and Wood Derived Fuels,1304803,0,1304803
2004,MO,Coal,150047110,0,150047110
2004,MO,Hydroelectric Conventional,0,2959828,2959828
2004,MO,Natural Gas,5729703,0,5729703
2004,MO,Nuclear,0,15661386,15661386
2004,MO,Other,220754,0,220754
2004,MO,Other Biomass,18884,0,18884
2004,MO,Other Gases,4800,0,4800
2004,MO,Petroleum,392321,0,392321
2004,MO,Pumped Storage,0,230650,230650
2004,MO,Total,0,175265821,175265821
2004,MO,Wood and Wood Derived Fuels,384,0,384
2004,MS,Coal,34955376,0,34955376
2004,MS,Natural Gas,23237134,0,23237134
2004,MS,Nuclear,0,20465532,20465532
2004,MS,Other,3082,0,3082
2004,MS,Other Biomass,6178,0,6178
2004,MS,Other Gases,81496,0,81496
2004,MS,Petroleum,5553714,0,5553714
2004,MS,Total,0,87325227,87325227
2004,MS,Wood and Wood Derived Fuels,3022714,0,3022714
2004,MT,Coal,34760456,0,34760456
2004,MT,Hydroelectric Conventional,0,17712062,17712062
2004,MT,Natural Gas,55906,0,55906
2004,MT,Other Gases,45944,0,45944
2004,MT,Petroleum,878274,0,878274
2004,MT,Total,0,53577536,53577536
2004,MT,Wood and Wood Derived Fuels,124892,0,124892
2004,NC,Coal,151092231,0,151092231
2004,NC,Hydroelectric Conventional,0,10870398,10870398
2004,NC,Natural Gas,5117309,0,5117309
2004,NC,Nuclear,0,80181246,80181246
2004,NC,Other,554805,0,554805
2004,NC,Other Biomass,224332,0,224332
2004,NC,Other Gases,0,0,0
2004,NC,Petroleum,1221819,0,1221819
2004,NC,Pumped Storage,0,156502,156502
2004,NC,Total,0,252659913,252659913
2004,NC,Wood and Wood Derived Fuels,3241272,0,3241272
2004,ND,Coal,56128448,0,56128448
2004,ND,Hydroelectric Conventional,0,3091728,3091728
2004,ND,Natural Gas,18088,0,18088
2004,ND,Other,0,0,0
2004,ND,Other Biomass,11206,0,11206
2004,ND,Other Gases,116834,0,116834
2004,ND,Petroleum,76862,0,76862
2004,ND,Total,0,59872212,59872212
2004,ND,Wind,0,429046,429046
2004,NE,Coal,40914170,0,40914170
2004,NE,Hydroelectric Conventional,0,1826042,1826042
2004,NE,Natural Gas,594780,0,594780
2004,NE,Nuclear,0,20482508,20482508
2004,NE,Other,0,0,0
2004,NE,Other Biomass,79036,0,79036
2004,NE,Other Gases,284,0,284
2004,NE,Petroleum,43736,0,43736
2004,NE,Total,0,64017418,64017418
2004,NE,Wind,0,76862,76862
2004,NH,Coal,8152150,0,8152150
2004,NH,Hydroelectric Conventional,0,2631512,2631512
2004,NH,Natural Gas,10799530,0,10799530
2004,NH,Nuclear,0,20355146,20355146
2004,NH,Other,125830,0,125830
2004,NH,Other Biomass,310372,0,310372
2004,NH,Petroleum,3920904,0,3920904
2004,NH,Total,0,47751574,47751574
2004,NH,Wood and Wood Derived Fuels,1456131,0,1456131
2004,NJ,Coal,20644968,0,20644968
2004,NJ,Hydroelectric Conventional,0,75006,75006
2004,NJ,Natural Gas,31924390,0,31924390
2004,NJ,Nuclear,0,54163132,54163132
2004,NJ,Other,992738,0,992738
2004,NJ,Other Biomass,1611664,0,1611664
2004,NJ,Other Gases,77558,0,77558
2004,NJ,Petroleum,2849705,0,2849705
2004,NJ,Pumped Storage,0,-574478,-574478
2004,NJ,Total,0,111764683,111764683
2004,NM,Coal,58527798,0,58527798
2004,NM,Hydroelectric Conventional,0,277894,277894
2004,NM,Natural Gas,5985347,0,5985347
2004,NM,Other Biomass,0,0,0
2004,NM,Petroleum,62752,0,62752
2004,NM,Total,0,65880721,65880721
2004,NM,Wind,0,1026930,1026930
2004,NV,Coal,36514530,0,36514530
2004,NV,Geothermal,2595008,0,2595008
2004,NV,Hydroelectric Conventional,0,3230246,3230246
2004,NV,Natural Gas,32761486,0,32761486
2004,NV,Other Gases,42066,0,42066
2004,NV,Petroleum,191532,0,191532
2004,NV,Total,0,75334870,75334870
2004,NY,Coal,45705408,0,45705408
2004,NY,Hydroelectric Conventional,0,47979323,47979323
2004,NY,Natural Gas,54588090,0,54588090
2004,NY,Nuclear,0,81280610,81280610
2004,NY,Other,1768750,0,1768750
2004,NY,Other Biomass,2596194,0,2596194
2004,NY,Petroleum,42410395,0,42410395
2004,NY,Pumped Storage,0,-1626342,-1626342
2004,NY,Total,0,275929587,275929587
2004,NY,Wind,0,232900,232900
2004,NY,Wood and Wood Derived Fuels,994258,0,994258
2004,OH,Coal,256313564,0,256313564
2004,OH,Hydroelectric Conventional,0,1459752,1459752
2004,OH,Natural Gas,2781990,0,2781990
2004,OH,Nuclear,0,31900242,31900242
2004,OH,Other,22,0,22
2004,OH,Other Biomass,60138,0,60138
2004,OH,Other Gases,604127,0,604127
2004,OH,Petroleum,2776561,0,2776561
2004,OH,Total,0,296691810,296691810
2004,OH,Wood and Wood Derived Fuels,795416,0,795416
2004,OK,Coal,67602772,0,67602772
2004,OK,Hydroelectric Conventional,0,5953352,5953352
2004,OK,Natural Gas,46571159,0,46571159
2004,OK,Other,17734,0,17734
2004,OK,Other Biomass,0,0,0
2004,OK,Petroleum,136625,0,136625
2004,OK,Pumped Storage,0,-467758,-467758
2004,OK,Total,0,121459120,121459120
2004,OK,Wind,0,1145488,1145488
2004,OK,Wood and Wood Derived Fuels,499750,0,499750
2004,OR,Coal,7111322,0,7111322
2004,OR,Hydroelectric Conventional,0,66161638,66161638
2004,OR,Natural Gas,27050366,0,27050366
2004,OR,Other,83158,0,83158
2004,OR,Other Biomass,172280,0,172280
2004,OR,Petroleum,125866,0,125866
2004,OR,Total,0,102762556,102762556
2004,OR,Wind,0,1238024,1238024
2004,OR,Wood and Wood Derived Fuels,819902,0,819902
2004,PA,Coal,234351567,0,234351567
2004,PA,Hydroelectric Conventional,0,6310676,6310676
2004,PA,Natural Gas,19627295,0,19627295
2004,PA,Nuclear,0,154917264,154917264
2004,PA,Other,1479492,0,1479492
2004,PA,Other Biomass,2578978,0,2578978
2004,PA,Other Gases,1167544,0,1167544
2004,PA,Petroleum,8283626,0,8283626
2004,PA,Pumped Storage,0,-1371768,-1371768
2004,PA,Total,0,429317001,429317001
2004,PA,Wind,0,612624,612624
2004,PA,Wood and Wood Derived Fuels,1359706,0,1359706
2004,RI,Hydroelectric Conventional,0,10922,10922
2004,RI,Natural Gas,9567814,0,9567814
2004,RI,Other Biomass,203052,0,203052
2004,RI,Petroleum,97050,0,97050
2004,RI,Total,0,9878840,9878840
2004,SC,Coal,77844440,0,77844440
2004,SC,Hydroelectric Conventional,0,4893818,4893818
2004,SC,Natural Gas,7595716,0,7595716
2004,SC,Nuclear,0,102401280,102401280
2004,SC,Other,173824,0,173824
2004,SC,Other Biomass,137920,0,137920
2004,SC,Other Gases,20,0,20
2004,SC,Petroleum,1742583,0,1742583
2004,SC,Pumped Storage,0,-2298180,-2298180
2004,SC,Total,0,195879858,195879858
2004,SC,Wood and Wood Derived Fuels,3388438,0,3388438
2004,SD,Coal,7240002,0,7240002
2004,SD,Hydroelectric Conventional,0,7195018,7195018
2004,SD,Natural Gas,224510,0,224510
2004,SD,Other,0,0,0
2004,SD,Petroleum,45542,0,45542
2004,SD,Total,0,15020428,15020428
2004,SD,Wind,0,315356,315356
2004,TN,Coal,116119264,0,116119264
2004,TN,Hydroelectric Conventional,0,20816224,20816224
2004,TN,Natural Gas,584972,0,584972
2004,TN,Nuclear,0,57224542,57224542
2004,TN,Other,11598,0,11598
2004,TN,Other Biomass,83606,0,83606
2004,TN,Other Gases,26650,0,26650
2004,TN,Petroleum,381628,0,381628
2004,TN,Pumped Storage,0,-1635652,-1635652
2004,TN,Total,0,195189084,195189084
2004,TN,Wind,0,7626,7626
2004,TN,Wood and Wood Derived Fuels,1568626,0,1568626
2004,TX,Coal,297769310,0,297769310
2004,TX,Hydroelectric Conventional,0,2601218,2601218
2004,TX,Natural Gas,377509326,0,377509326
2004,TX,Nuclear,0,80870744,80870744
2004,TX,Other,1489111,0,1489111
2004,TX,Other Biomass,503560,0,503560
2004,TX,Other Gases,8407368,0,8407368
2004,TX,Petroleum,3457812,0,3457812
2004,TX,Total,0,780598264,780598264
2004,TX,Wind,0,6275380,6275380
2004,TX,Wood and Wood Derived Fuels,1714434,0,1714434
2004,UT,Coal,73235708,0,73235708
2004,UT,Geothermal,389752,0,389752
2004,UT,Hydroelectric Conventional,0,899696,899696
2004,UT,Natural Gas,1819700,0,1819700
2004,UT,Other,6252,0,6252
2004,UT,Other Biomass,7642,0,7642
2004,UT,Other Gases,0,0,0
2004,UT,Petroleum,65202,0,65202
2004,UT,Total,0,76423954,76423954
2004,VA,Coal,71312012,0,71312012
2004,VA,Hydroelectric Conventional,0,3166100,3166100
2004,VA,Natural Gas,12875618,0,12875618
2004,VA,Nuclear,0,56630588,56630588
2004,VA,Other,976047,0,976047
2004,VA,Other Biomass,1398474,0,1398474
2004,VA,Other Gases,0,0,0
2004,VA,Petroleum,10307224,0,10307224
2004,VA,Pumped Storage,0,-2332222,-2332222
2004,VA,Total,0,157800080,157800080
2004,VA,Wood and Wood Derived Fuels,3466240,0,3466240
2004,VT,Hydroelectric Conventional,0,2374512,2374512
2004,VT,Natural Gas,6448,0,6448
2004,VT,Nuclear,0,7716040,7716040
2004,VT,Petroleum,35600,0,35600
2004,VT,Total,0,10940757,10940757
2004,VT,Wind,0,22728,22728
2004,VT,Wood and Wood Derived Fuels,785428,0,785428
2004,WA,Coal,20818662,0,20818662
2004,WA,Hydroelectric Conventional,0,143151400,143151400
2004,WA,Natural Gas,16937600,0,16937600
2004,WA,Nuclear,0,17963166,17963166
2004,WA,Other,133728,0,133728
2004,WA,Other Biomass,370891,0,370891
2004,WA,Other Gases,550568,0,550568
2004,WA,Petroleum,171768,0,171768
2004,WA,Pumped Storage,0,-19636,-19636
2004,WA,Total,0,204330104,204330104
2004,WA,Wind,0,1473152,1473152
2004,WA,Wood and Wood Derived Fuels,2778806,0,2778806
2004,WI,Coal,84296352,0,84296352
2004,WI,Hydroelectric Conventional,0,3961352,3961352
2004,WI,Natural Gas,4810724,0,4810724
2004,WI,Nuclear,0,23775698,23775698
2004,WI,Other,227225,0,227225
2004,WI,Other Biomass,810886,0,810886
2004,WI,Petroleum,1591238,0,1591238
2004,WI,Total,0,120889866,120889866
2004,WI,Wind,0,207126,207126
2004,WI,Wood and Wood Derived Fuels,1209268,0,1209268
2004,WV,Coal,175169195,0,175169195
2004,WV,Hydroelectric Conventional,0,2636558,2636558
2004,WV,Natural Gas,510619,0,510619
2004,WV,Other,25506,0,25506
2004,WV,Other Biomass,3038,0,3038
2004,WV,Other Gases,295604,0,295604
2004,WV,Petroleum,535116,0,535116
2004,WV,Total,0,179499124,179499124
2004,WV,Wind,0,322382,322382
2004,WV,Wood and Wood Derived Fuels,1104,0,1104
2004,WY,Coal,86691480,0,86691480
2004,WY,Hydroelectric Conventional,0,1186294,1186294
2004,WY,Natural Gas,173794,0,173794
2004,WY,Other,213400,0,213400
2004,WY,Other Gases,25492,0,25492
2004,WY,Petroleum,91718,0,91718
2004,WY,Total,0,89615208,89615208
2004,WY,Wind,0,1233030,1233030
2005,AK,Coal,1248636,0,1248636
2005,AK,Hydroelectric Conventional,0,2927884,2927884
2005,AK,Natural Gas,7447252,0,7447252
2005,AK,Other Biomass,9746,0,9746
2005,AK,Petroleum,1517857,0,1517857
2005,AK,Total,0,13153318,13153318
2005,AK,Wind,0,1178,1178
2005,AK,Wood and Wood Derived Fuels,766,0,766
2005,AL,Coal,156256915,0,156256915
2005,AL,Hydroelectric Conventional,0,20289162,20289162
2005,AL,Natural Gas,27738902,0,27738902
2005,AL,Nuclear,0,63388446,63388446
2005,AL,Other,50186,0,50186
2005,AL,Other Biomass,32828,0,32828
2005,AL,Other Gases,213728,0,213728
2005,AL,Petroleum,666220,0,666220
2005,AL,Total,0,275897162,275897162
2005,AL,Wood and Wood Derived Fuels,7260776,0,7260776
2005,AR,Coal,46074288,0,46074288
2005,AR,Hydroelectric Conventional,0,6165032,6165032
2005,AR,Natural Gas,12011320,0,12011320
2005,AR,Nuclear,0,27379142,27379142
2005,AR,Other,30586,0,30586
2005,AR,Other Biomass,55386,0,55386
2005,AR,Petroleum,416202,0,416202
2005,AR,Pumped Storage,0,41404,41404
2005,AR,Total,0,95589017,95589017
2005,AR,Wood and Wood Derived Fuels,3415660,0,3415660
2005,AZ,Coal,80287068,0,80287068
2005,AZ,Hydroelectric Conventional,0,12820128,12820128
2005,AZ,Natural Gas,57786027,0,57786027
2005,AZ,Nuclear,0,51614892,51614892
2005,AZ,Other Biomass,96712,0,96712
2005,AZ,Petroleum,86474,0,86474
2005,AZ,Pumped Storage,0,214730,214730
2005,AZ,Solar Thermal and Photovoltaic,0,27162,27162
2005,AZ,Total,0,202957308,202957308
2005,AZ,Wood and Wood Derived Fuels,24116,0,24116
2005,CA,Coal,4270749,0,4270749
2005,CA,Geothermal,26045278,0,26045278
2005,CA,Hydroelectric Conventional,0,79263734,79263734
2005,CA,Natural Gas,186707698,0,186707698
2005,CA,Nuclear,0,72309796,72309796
2005,CA,Other,839015,0,839015
2005,CA,Other Biomass,4447053,0,4447053
2005,CA,Other Gases,4559167,0,4559167
2005,CA,Petroleum,5087395,0,5087395
2005,CA,Pumped Storage,0,239586,239586
2005,CA,Solar Thermal and Photovoltaic,0,1073426,1073426
2005,CA,Total,0,400585637,400585637
2005,CA,Wind,0,8524458,8524458
2005,CA,Wood and Wood Derived Fuels,7218279,0,7218279
2005,CO,Coal,71140270,0,71140270
2005,CO,Hydroelectric Conventional,0,2830592,2830592
2005,CO,Natural Gas,23846580,0,23846580
2005,CO,Other,0,0,0
2005,CO,Other Biomass,67758,0,67758
2005,CO,Other Gases,4860,0,4860
2005,CO,Petroleum,34091,0,34091
2005,CO,Pumped Storage,0,-244126,-244126
2005,CO,Total,0,99233389,99233389
2005,CO,Wind,0,1552468,1552468
2005,CO,Wood and Wood Derived Fuels,896,0,896
2005,CT,Coal,7992984,0,7992984
2005,CT,Hydroelectric Conventional,0,956398,956398
2005,CT,Natural Gas,17727784,0,17727784
2005,CT,Nuclear,0,31124244,31124244
2005,CT,Other,1479904,0,1479904
2005,CT,Other Biomass,1492042,0,1492042
2005,CT,Other Gases,3132,0,3132
2005,CT,Petroleum,6311684,0,6311684
2005,CT,Pumped Storage,0,-3306,-3306
2005,CT,Total,0,67099495,67099495
2005,CT,Wood and Wood Derived Fuels,14628,0,14628
2005,DC,Petroleum,452084,0,452084
2005,DC,Total,0,452084,452084
2005,DE,Coal,9665688,0,9665688
2005,DE,Natural Gas,3181634,0,3181634
2005,DE,Other Gases,985336,0,985336
2005,DE,Petroleum,2440479,0,2440479
2005,DE,Total,0,16273136,16273136
2005,FL,Coal,125030603,0,125030603
2005,FL,Hydroelectric Conventional,0,532318,532318
2005,FL,Natural Gas,167190390,0,167190390
2005,FL,Nuclear,0,57517652,57517652
2005,FL,Other,7158921,0,7158921
2005,FL,Other Biomass,4609913,0,4609913
2005,FL,Other Gases,26479,0,26479
2005,FL,Petroleum,74402068,0,74402068
2005,FL,Total,0,440512823,440512823
2005,FL,Wood and Wood Derived Fuels,4044480,0,4044480
2005,GA,Coal,174364518,0,174364518
2005,GA,Hydroelectric Conventional,0,8064106,8064106
2005,GA,Natural Gas,19542068,0,19542068
2005,GA,Nuclear,0,63068518,63068518
2005,GA,Other,105054,0,105054
2005,GA,Other Biomass,154246,0,154246
2005,GA,Petroleum,2066184,0,2066184
2005,GA,Pumped Storage,0,-418442,-418442
2005,GA,Total,0,273335783,273335783
2005,GA,Wood and Wood Derived Fuels,6389530,0,6389530
2005,HI,Coal,3261836,0,3261836
2005,HI,Geothermal,443194,0,443194
2005,HI,Hydroelectric Conventional,0,192376,192376
2005,HI,Other,298012,0,298012
2005,HI,Other Biomass,619479,0,619479
2005,HI,Other Gases,82266,0,82266
2005,HI,Petroleum,18135184,0,18135184
2005,HI,Total,0,23045610,23045610
2005,HI,Wind,0,13264,13264
2005,IA,Coal,68504668,0,68504668
2005,IA,Hydroelectric Conventional,0,1919052,1919052
2005,IA,Natural Gas,4961739,0,4961739
2005,IA,Nuclear,0,9076626,9076626
2005,IA,Other,23146,0,23146
2005,IA,Other Biomass,233685,0,233685
2005,IA,Petroleum,299135,0,299135
2005,IA,Total,0,88312319,88312319
2005,IA,Wind,0,3294268,3294268
2005,ID,Coal,190362,0,190362
2005,ID,Hydroelectric Conventional,0,17084242,17084242
2005,ID,Natural Gas,3194559,0,3194559
2005,ID,Other,61532,0,61532
2005,ID,Petroleum,10,0,10
2005,ID,Total,0,21649968,21649968
2005,ID,Wood and Wood Derived Fuels,1119262,0,1119262
2005,IL,Coal,184530380,0,184530380
2005,IL,Hydroelectric Conventional,0,258074,258074
2005,IL,Natural Gas,14228502,0,14228502
2005,IL,Nuclear,0,186526002,186526002
2005,IL,Other,79594,0,79594
2005,IL,Other Biomass,1283470,0,1283470
2005,IL,Other Gases,397598,0,397598
2005,IL,Petroleum,654380,0,654380
2005,IL,Total,0,388240292,388240292
2005,IL,Wind,0,282292,282292
2005,IN,Coal,245666956,0,245666956
2005,IN,Hydroelectric Conventional,0,876564,876564
2005,IN,Natural Gas,7230610,0,7230610
2005,IN,Other,868888,0,868888
2005,IN,Other Biomass,135385,0,135385
2005,IN,Other Gases,5443154,0,5443154
2005,IN,Petroleum,521588,0,521588
2005,IN,Total,0,260743146,260743146
2005,KS,Coal,68961462,0,68961462
2005,KS,Hydroelectric Conventional,0,22674,22674
2005,KS,Natural Gas,2274964,0,2274964
2005,KS,Nuclear,0,17641890,17641890
2005,KS,Petroleum,1972756,0,1972756
2005,KS,Total,0,91725392,91725392
2005,KS,Wind,0,851646,851646
2005,KY,Coal,178166226,0,178166226
2005,KY,Hydroelectric Conventional,0,5922386,5922386
2005,KY,Natural Gas,3308104,0,3308104
2005,KY,Other,33946,0,33946
2005,KY,Other Biomass,126632,0,126632
2005,KY,Other Gases,9982,0,9982
2005,KY,Petroleum,7361370,0,7361370
2005,KY,Total,0,195644838,195644838
2005,KY,Wood and Wood Derived Fuels,716192,0,716192
2005,LA,Coal,46174730,0,46174730
2005,LA,Hydroelectric Conventional,0,1621896,1621896
2005,LA,Natural Gas,88335808,0,88335808
2005,LA,Nuclear,0,31352706,31352706
2005,LA,Other,1099462,0,1099462
2005,LA,Other Biomass,160794,0,160794
2005,LA,Other Gases,3793450,0,3793450
2005,LA,Petroleum,7082168,0,7082168
2005,LA,Total,0,185233756,185233756
2005,LA,Wood and Wood Derived Fuels,5612742,0,5612742
2005,MA,Coal,24067093,0,24067093
2005,MA,Hydroelectric Conventional,0,2083900,2083900
2005,MA,Natural Gas,40738934,0,40738934
2005,MA,Nuclear,0,10950114,10950114
2005,MA,Other,1544614,0,1544614
2005,MA,Other Biomass,2276576,0,2276576
2005,MA,Petroleum,14052888,0,14052888
2005,MA,Pumped Storage,0,-923286,-923286
2005,MA,Total,0,95030886,95030886
2005,MA,Wood and Wood Derived Fuels,240054,0,240054
2005,MD,Coal,58605584,0,58605584
2005,MD,Hydroelectric Conventional,0,3407278,3407278
2005,MD,Natural Gas,3773973,0,3773973
2005,MD,Nuclear,0,29406442,29406442
2005,MD,Other,587122,0,587122
2005,MD,Other Biomass,834760,0,834760
2005,MD,Other Gases,684932,0,684932
2005,MD,Petroleum,7611138,0,7611138
2005,MD,Total,0,105323200,105323200
2005,MD,Wood and Wood Derived Fuels,411970,0,411970
2005,ME,Coal,640543,0,640543
2005,ME,Hydroelectric Conventional,0,8181852,8181852
2005,ME,Natural Gas,16796906,0,16796906
2005,ME,Other,689385,0,689385
2005,ME,Other Biomass,580461,0,580461
2005,ME,Other Gases,108,0,108
2005,ME,Petroleum,3242781,0,3242781
2005,ME,Total,0,37687956,37687956
2005,ME,Wood and Wood Derived Fuels,7555918,0,7555918
2005,MI,Coal,140645952,0,140645952
2005,MI,Hydroelectric Conventional,0,2923416,2923416
2005,MI,Natural Gas,27527784,0,27527784
2005,MI,Nuclear,0,65743148,65743148
2005,MI,Other,1123723,0,1123723
2005,MI,Other Biomass,1433122,0,1433122
2005,MI,Other Gases,744238,0,744238
2005,MI,Petroleum,1755118,0,1755118
2005,MI,Pumped Storage,0,-2212482,-2212482
2005,MI,Total,0,243239542,243239542
2005,MI,Wind,0,3696,3696
2005,MI,Wood and Wood Derived Fuels,3551828,0,3551828
2005,MN,Coal,65899690,0,65899690
2005,MN,Hydroelectric Conventional,0,1549458,1549458
2005,MN,Natural Gas,5414534,0,5414534
2005,MN,Nuclear,0,25670438,25670438
2005,MN,Other,647036,0,647036
2005,MN,Other Biomass,826562,0,826562
2005,MN,Petroleum,1552619,0,1552619
2005,MN,Total,0,106037990,106037990
2005,MN,Wind,0,3164954,3164954
2005,MN,Wood and Wood Derived Fuels,1312699,0,1312699
2005,MO,Coal,154873119,0,154873119
2005,MO,Hydroelectric Conventional,0,2318652,2318652
2005,MO,Natural Gas,7731891,0,7731891
2005,MO,Nuclear,0,16061154,16061154
2005,MO,Other,139474,0,139474
2005,MO,Other Biomass,17196,0,17196
2005,MO,Other Gases,4766,0,4766
2005,MO,Petroleum,338346,0,338346
2005,MO,Pumped Storage,0,171864,171864
2005,MO,Total,0,181656460,181656460
2005,MO,Wood and Wood Derived Fuels,0,0,0
2005,MS,Coal,33271768,0,33271768
2005,MS,Natural Gas,30720131,0,30720131
2005,MS,Nuclear,0,20155692,20155692
2005,MS,Other,13894,0,13894
2005,MS,Other Biomass,10688,0,10688
2005,MS,Other Gases,40332,0,40332
2005,MS,Petroleum,2889696,0,2889696
2005,MS,Total,0,90134906,90134906
2005,MS,Wood and Wood Derived Fuels,3032706,0,3032706
2005,MT,Coal,35646678,0,35646678
2005,MT,Hydroelectric Conventional,0,19174698,19174698
2005,MT,Natural Gas,53876,0,53876
2005,MT,Other Gases,29330,0,29330
2005,MT,Petroleum,829752,0,829752
2005,MT,Total,0,55877556,55877556
2005,MT,Wood and Wood Derived Fuels,143224,0,143224
2005,NC,Coal,156871400,0,156871400
2005,NC,Hydroelectric Conventional,0,10793004,10793004
2005,NC,Natural Gas,6318754,0,6318754
2005,NC,Nuclear,0,79963478,79963478
2005,NC,Other,605474,0,605474
2005,NC,Other Biomass,196884,0,196884
2005,NC,Other Gases,0,0,0
2005,NC,Petroleum,1037739,0,1037739
2005,NC,Pumped Storage,0,293010,293010
2005,NC,Total,0,259497156,259497156
2005,NC,Wood and Wood Derived Fuels,3417412,0,3417412
2005,ND,Coal,60517518,0,60517518
2005,ND,Hydroelectric Conventional,0,2683648,2683648
2005,ND,Natural Gas,16024,0,16024
2005,ND,Other Biomass,19978,0,19978
2005,ND,Other Gases,118844,0,118844
2005,ND,Petroleum,68530,0,68530
2005,ND,Total,0,63865230,63865230
2005,ND,Wind,0,440690,440690
2005,NE,Coal,41636342,0,41636342
2005,NE,Hydroelectric Conventional,0,1742946,1742946
2005,NE,Natural Gas,1605966,0,1605966
2005,NE,Nuclear,0,17603682,17603682
2005,NE,Other Biomass,85292,0,85292
2005,NE,Other Gases,12,0,12
2005,NE,Petroleum,62011,0,62011
2005,NE,Total,0,62929468,62929468
2005,NE,Wind,0,193216,193216
2005,NH,Coal,8145974,0,8145974
2005,NH,Hydroelectric Conventional,0,3597806,3597806
2005,NH,Natural Gas,13569470,0,13569470
2005,NH,Nuclear,0,18911770,18911770
2005,NH,Other,116924,0,116924
2005,NH,Other Biomass,312332,0,312332
2005,NH,Other Gases,0,0,0
2005,NH,Petroleum,2714288,0,2714288
2005,NH,Total,0,48940026,48940026
2005,NH,Wood and Wood Derived Fuels,1571462,0,1571462
2005,NJ,Coal,23250838,0,23250838
2005,NJ,Hydroelectric Conventional,0,62226,62226
2005,NJ,Natural Gas,30732330,0,30732330
2005,NJ,Nuclear,0,62783370,62783370
2005,NJ,Other,1075218,0,1075218
2005,NJ,Other Biomass,1749811,0,1749811
2005,NJ,Other Gases,129864,0,129864
2005,NJ,Petroleum,1880925,0,1880925
2005,NJ,Pumped Storage,0,-565414,-565414
2005,NJ,Total,0,121099165,121099165
2005,NM,Coal,59894496,0,59894496
2005,NM,Hydroelectric Conventional,0,329986,329986
2005,NM,Natural Gas,8374430,0,8374430
2005,NM,Other Biomass,9294,0,9294
2005,NM,Petroleum,73818,0,73818
2005,NM,Total,0,70271284,70271284
2005,NM,Wind,0,1589260,1589260
2005,NV,Coal,36768522,0,36768522
2005,NV,Geothermal,2525414,0,2525414
2005,NV,Hydroelectric Conventional,0,3404760,3404760
2005,NV,Natural Gas,37671246,0,37671246
2005,NV,Other Gases,16562,0,16562
2005,NV,Petroleum,41000,0,41000
2005,NV,Total,0,80427504,80427504
2005,NY,Coal,41195280,0,41195280
2005,NY,Hydroelectric Conventional,0,51565036,51565036
2005,NY,Natural Gas,63745402,0,63745402
2005,NY,Nuclear,0,84886304,84886304
2005,NY,Other,1941814,0,1941814
2005,NY,Other Biomass,2715476,0,2715476
2005,NY,Petroleum,48025566,0,48025566
2005,NY,Pumped Storage,0,-1561462,-1561462
2005,NY,Total,0,293774838,293774838
2005,NY,Wind,0,205980,205980
2005,NY,Wood and Wood Derived Fuels,1055443,0,1055443
2005,OH,Coal,273651196,0,273651196
2005,OH,Hydroelectric Conventional,0,1031488,1031488
2005,OH,Natural Gas,5391256,0,5391256
2005,OH,Nuclear,0,29605466,29605466
2005,OH,Other,4598,0,4598
2005,OH,Other Biomass,53522,0,53522
2005,OH,Other Gases,596679,0,596679
2005,OH,Petroleum,2780786,0,2780786
2005,OH,Total,0,313952646,313952646
2005,OH,Wind,0,26536,26536
2005,OH,Wood and Wood Derived Fuels,811120,0,811120
2005,OK,Coal,72617113,0,72617113
2005,OK,Hydroelectric Conventional,0,5260722,5260722
2005,OK,Natural Gas,57180440,0,57180440
2005,OK,Other,12628,0,12628
2005,OK,Other Biomass,0,0,0
2005,OK,Other Gases,37676,0,37676
2005,OK,Petroleum,140683,0,140683
2005,OK,Pumped Storage,0,-307650,-307650
2005,OK,Total,0,137215654,137215654
2005,OK,Wind,0,1695546,1695546
2005,OK,Wood and Wood Derived Fuels,578496,0,578496
2005,OR,Coal,6932972,0,6932972
2005,OR,Hydroelectric Conventional,0,61896690,61896690
2005,OR,Natural Gas,26381992,0,26381992
2005,OR,Other,80954,0,80954
2005,OR,Other Biomass,196086,0,196086
2005,OR,Petroleum,156374,0,156374
2005,OR,Total,0,98650005,98650005
2005,OR,Wind,0,1468548,1468548
2005,OR,Wood and Wood Derived Fuels,1536390,0,1536390
2005,PA,Coal,241866508,0,241866508
2005,PA,Hydroelectric Conventional,0,4464358,4464358
2005,PA,Natural Gas,21615500,0,21615500
2005,PA,Nuclear,0,152578864,152578864
2005,PA,Other,1461231,0,1461231
2005,PA,Other Biomass,2715406,0,2715406
2005,PA,Other Gases,1080130,0,1080130
2005,PA,Petroleum,9879125,0,9879125
2005,PA,Pumped Storage,0,-1422082,-1422082
2005,PA,Total,0,436182250,436182250
2005,PA,Wind,0,568482,568482
2005,PA,Wood and Wood Derived Fuels,1374728,0,1374728
2005,RI,Hydroelectric Conventional,0,13468,13468
2005,RI,Natural Gas,11978781,0,11978781
2005,RI,Other Biomass,0,0,0
2005,RI,Petroleum,114340,0,114340
2005,RI,Total,0,12106588,12106588
2005,SC,Coal,79384118,0,79384118
2005,SC,Hydroelectric Conventional,0,5876294,5876294
2005,SC,Natural Gas,10828366,0,10828366
2005,SC,Nuclear,0,106275108,106275108
2005,SC,Other,187360,0,187360
2005,SC,Other Biomass,175318,0,175318
2005,SC,Other Gases,11284,0,11284
2005,SC,Petroleum,1236869,0,1236869
2005,SC,Pumped Storage,0,-2397350,-2397350
2005,SC,Total,0,205029330,205029330
2005,SC,Wood and Wood Derived Fuels,3451962,0,3451962
2005,SD,Coal,5992694,0,5992694
2005,SD,Hydroelectric Conventional,0,6149132,6149132
2005,SD,Natural Gas,541892,0,541892
2005,SD,Other,42,0,42
2005,SD,Petroleum,41570,0,41570
2005,SD,Total,0,13041538,13041538
2005,SD,Wind,0,316208,316208
2005,TN,Coal,118102952,0,118102952
2005,TN,Hydroelectric Conventional,0,18619082,18619082
2005,TN,Natural Gas,1062330,0,1062330
2005,TN,Nuclear,0,55606216,55606216
2005,TN,Other,17200,0,17200
2005,TN,Other Biomass,136382,0,136382
2005,TN,Other Gases,29196,0,29196
2005,TN,Petroleum,461054,0,461054
2005,TN,Pumped Storage,0,-1195870,-1195870
2005,TN,Total,0,194234330,194234330
2005,TN,Wind,0,6678,6678
2005,TN,Wood and Wood Derived Fuels,1389110,0,1389110
2005,TX,Coal,296716046,0,296716046
2005,TX,Hydroelectric Conventional,0,2665120,2665120
2005,TX,Natural Gas,395330516,0,395330516
2005,TX,Nuclear,0,76464986,76464986
2005,TX,Other,1780626,0,1780626
2005,TX,Other Biomass,493410,0,493410
2005,TX,Other Gases,6543537,0,6543537
2005,TX,Petroleum,3165391,0,3165391
2005,TX,Total,0,793337443,793337443
2005,TX,Wind,0,8474418,8474418
2005,TX,Wood and Wood Derived Fuels,1703396,0,1703396
2005,UT,Coal,71940810,0,71940810
2005,UT,Geothermal,369604,0,369604
2005,UT,Hydroelectric Conventional,0,1568926,1568926
2005,UT,Natural Gas,2355002,0,2355002
2005,UT,Other,6204,0,6204
2005,UT,Other Biomass,7896,0,7896
2005,UT,Other Gases,0,0,0
2005,UT,Petroleum,81818,0,81818
2005,UT,Total,0,76330262,76330262
2005,VA,Coal,70849750,0,70849750
2005,VA,Hydroelectric Conventional,0,2968706,2968706
2005,VA,Natural Gas,16589541,0,16589541
2005,VA,Nuclear,0,55836962,55836962
2005,VA,Other,957669,0,957669
2005,VA,Other Biomass,1390406,0,1390406
2005,VA,Other Gases,0,0,0
2005,VA,Petroleum,8529318,0,8529318
2005,VA,Pumped Storage,0,-2841646,-2841646
2005,VA,Total,0,157886090,157886090
2005,VA,Wood and Wood Derived Fuels,3605386,0,3605386
2005,VT,Hydroelectric Conventional,0,2421622,2421622
2005,VT,Natural Gas,4480,0,4480
2005,VT,Nuclear,0,8143094,8143094
2005,VT,Petroleum,20358,0,20358
2005,VT,Total,0,11433510,11433510
2005,VT,Wind,0,22972,22972
2005,VT,Wood and Wood Derived Fuels,820982,0,820982
2005,WA,Coal,20988814,0,20988814
2005,WA,Hydroelectric Conventional,0,144149298,144149298
2005,WA,Natural Gas,17157091,0,17157091
2005,WA,Nuclear,0,16484546,16484546
2005,WA,Other,129644,0,129644
2005,WA,Other Biomass,380780,0,380780
2005,WA,Other Gases,643448,0,643448
2005,WA,Petroleum,134590,0,134590
2005,WA,Pumped Storage,0,16946,16946
2005,WA,Total,0,203931700,203931700
2005,WA,Wind,0,996940,996940
2005,WA,Wood and Wood Derived Fuels,2849604,0,2849604
2005,WI,Coal,83458627,0,83458627
2005,WI,Hydroelectric Conventional,0,3480438,3480438
2005,WI,Natural Gas,12773588,0,12773588
2005,WI,Nuclear,0,19841982,19841982
2005,WI,Other,238366,0,238366
2005,WI,Other Biomass,697518,0,697518
2005,WI,Petroleum,1493021,0,1493021
2005,WI,Total,0,123649328,123649328
2005,WI,Wind,0,185088,185088
2005,WI,Wood and Wood Derived Fuels,1480700,0,1480700
2005,WV,Coal,182834007,0,182834007
2005,WV,Hydroelectric Conventional,0,2895132,2895132
2005,WV,Natural Gas,574184,0,574184
2005,WV,Other,22430,0,22430
2005,WV,Other Biomass,506,0,506
2005,WV,Other Gases,171022,0,171022
2005,WV,Petroleum,446586,0,446586
2005,WV,Total,0,187252571,187252571
2005,WV,Wind,0,307784,307784
2005,WV,Wood and Wood Derived Fuels,920,0,920
2005,WY,Coal,86691352,0,86691352
2005,WY,Hydroelectric Conventional,0,1616750,1616750
2005,WY,Natural Gas,649962,0,649962
2005,WY,Other,130240,0,130240
2005,WY,Other Gases,527172,0,527172
2005,WY,Petroleum,84610,0,84610
2005,WY,Total,0,91134614,91134614
2005,WY,Wind,0,1434528,1434528
2006,AK,Coal,1234838,0,1234838
2006,AK,Hydroelectric Conventional,0,2447214,2447214
2006,AK,Natural Gas,8115460,0,8115460
2006,AK,Other Biomass,12298,0,12298
2006,AK,Petroleum,1535976,0,1535976
2006,AK,Total,0,13348394,13348394
2006,AK,Wind,0,1576,1576
2006,AK,Wood and Wood Derived Fuels,1032,0,1032
2006,AL,Coal,156217336,0,156217336
2006,AL,Hydroelectric Conventional,0,14503572,14503572
2006,AL,Natural Gas,38814443,0,38814443
2006,AL,Nuclear,0,63822192,63822192
2006,AL,Other,41866,0,41866
2006,AL,Other Biomass,38904,0,38904
2006,AL,Other Gases,262218,0,262218
2006,AL,Petroleum,360332,0,360332
2006,AL,Total,0,281790882,281790882
2006,AL,Wood and Wood Derived Fuels,7730020,0,7730020
2006,AR,Coal,48366100,0,48366100
2006,AR,Hydroelectric Conventional,0,3101116,3101116
2006,AR,Natural Gas,18564772,0,18564772
2006,AR,Nuclear,0,30465154,30465154
2006,AR,Other,43730,0,43730
2006,AR,Other Biomass,66852,0,66852
2006,AR,Petroleum,321486,0,321486
2006,AR,Pumped Storage,0,29438,29438
2006,AR,Total,0,104337406,104337406
2006,AR,Wood and Wood Derived Fuels,3378758,0,3378758
2006,AZ,Coal,80885710,0,80885710
2006,AZ,Hydroelectric Conventional,0,13585808,13585808
2006,AZ,Natural Gas,65738095,0,65738095
2006,AZ,Nuclear,0,48024462,48024462
2006,AZ,Other Biomass,64386,0,64386
2006,AZ,Petroleum,146742,0,146742
2006,AZ,Pumped Storage,0,297104,297104
2006,AZ,Solar Thermal and Photovoltaic,0,26268,26268
2006,AZ,Total,0,208785056,208785056
2006,AZ,Wood and Wood Derived Fuels,16480,0,16480
2006,CA,Coal,4470684,0,4470684
2006,CA,Geothermal,25642868,0,25642868
2006,CA,Hydroelectric Conventional,0,96094760,96094760
2006,CA,Natural Gas,211382232,0,211382232
2006,CA,Nuclear,0,63917242,63917242
2006,CA,Other,928153,0,928153
2006,CA,Other Biomass,4588990,0,4588990
2006,CA,Other Gases,4044892,0,4044892
2006,CA,Petroleum,4736348,0,4736348
2006,CA,Pumped Storage,0,192274,192274
2006,CA,Solar Thermal and Photovoltaic,0,989144,989144
2006,CA,Total,0,433597376,433597376
2006,CA,Wind,0,9765602,9765602
2006,CA,Wood and Wood Derived Fuels,6844186,0,6844186
2006,CO,Coal,72538850,0,72538850
2006,CO,Hydroelectric Conventional,0,3582414,3582414
2006,CO,Natural Gas,23837279,0,23837279
2006,CO,Other,0,0,0
2006,CO,Other Biomass,61384,0,61384
2006,CO,Other Gases,5038,0,5038
2006,CO,Petroleum,41674,0,41674
2006,CO,Pumped Storage,0,-401004,-401004
2006,CO,Total,0,101396706,101396706
2006,CO,Wind,0,1731072,1731072
2006,CO,Wood and Wood Derived Fuels,0,0,0
2006,CT,Coal,8563032,0,8563032
2006,CT,Hydroelectric Conventional,0,1087784,1087784
2006,CT,Natural Gas,20968963,0,20968963
2006,CT,Nuclear,0,33178892,33178892
2006,CT,Other,1477200,0,1477200
2006,CT,Other Biomass,1509552,0,1509552
2006,CT,Other Gases,3294,0,3294
2006,CT,Petroleum,2557668,0,2557668
2006,CT,Pumped Storage,0,0,0
2006,CT,Total,0,69363472,69363472
2006,CT,Wood and Wood Derived Fuels,17088,0,17088
2006,DC,Petroleum,162934,0,162934
2006,DC,Total,0,162934,162934
2006,DE,Coal,9937624,0,9937624
2006,DE,Natural Gas,2341536,0,2341536
2006,DE,Other Biomass,834,0,834
2006,DE,Other Gases,1820536,0,1820536
2006,DE,Petroleum,263830,0,263830
2006,DE,Total,0,14364359,14364359
2006,FL,Coal,130846673,0,130846673
2006,FL,Hydroelectric Conventional,0,406844,406844
2006,FL,Natural Gas,192372280,0,192372280
2006,FL,Nuclear,0,62852698,62852698
2006,FL,Other,6521342,0,6521342
2006,FL,Other Biomass,4703402,0,4703402
2006,FL,Other Gases,33848,0,33848
2006,FL,Petroleum,45808180,0,45808180
2006,FL,Total,0,447503242,447503242
2006,FL,Wood and Wood Derived Fuels,3957976,0,3957976
2006,GA,Coal,173007972,0,173007972
2006,GA,Hydroelectric Conventional,0,5137674,5137674
2006,GA,Natural Gas,25921197,0,25921197
2006,GA,Nuclear,0,64011620,64011620
2006,GA,Other,236352,0,236352
2006,GA,Other Biomass,113416,0,113416
2006,GA,Petroleum,1668450,0,1668450
2006,GA,Pumped Storage,0,-800686,-800686
2006,GA,Total,0,276020416,276020416
2006,GA,Wood and Wood Derived Fuels,6724420,0,6724420
2006,HI,Coal,3097190,0,3097190
2006,HI,Geothermal,424552,0,424552
2006,HI,Hydroelectric Conventional,0,240174,240174
2006,HI,Other,351238,0,351238
2006,HI,Other Biomass,651385,0,651385
2006,HI,Other Gases,85514,0,85514
2006,HI,Petroleum,18108947,0,18108947
2006,HI,Total,0,23118348,23118348
2006,HI,Wind,0,159348,159348
2006,IA,Coal,68810388,0,68810388
2006,IA,Hydroelectric Conventional,0,1818696,1818696
2006,IA,Natural Gas,4800028,0,4800028
2006,IA,Nuclear,0,10190884,10190884
2006,IA,Other,20852,0,20852
2006,IA,Other Biomass,273792,0,273792
2006,IA,Petroleum,416642,0,416642
2006,IA,Total,0,90966924,90966924
2006,IA,Wind,0,4635642,4635642
2006,ID,Coal,164604,0,164604
2006,ID,Hydroelectric Conventional,0,22484744,22484744
2006,ID,Natural Gas,2596789,0,2596789
2006,ID,Other,145832,0,145832
2006,ID,Petroleum,288,0,288
2006,ID,Total,0,26772170,26772170
2006,ID,Wind,0,339234,339234
2006,ID,Wood and Wood Derived Fuels,1040680,0,1040680
2006,IL,Coal,183297528,0,183297528
2006,IL,Hydroelectric Conventional,0,346544,346544
2006,IL,Natural Gas,10557996,0,10557996
2006,IL,Nuclear,0,188308280,188308280
2006,IL,Other,76766,0,76766
2006,IL,Other Biomass,1188522,0,1188522
2006,IL,Other Gases,297645,0,297645
2006,IL,Petroleum,271494,0,271494
2006,IL,Total,0,384853917,384853917
2006,IL,Wind,0,509142,509142
2006,IN,Coal,247290933,0,247290933
2006,IN,Hydroelectric Conventional,0,979030,979030
2006,IN,Natural Gas,5363766,0,5363766
2006,IN,Other,869952,0,869952
2006,IN,Other Biomass,440425,0,440425
2006,IN,Other Gases,5740198,0,5740198
2006,IN,Petroleum,295269,0,295269
2006,IN,Total,0,260979576,260979576
2006,KS,Coal,66562760,0,66562760
2006,KS,Hydroelectric Conventional,0,19298,19298
2006,KS,Natural Gas,3678812,0,3678812
2006,KS,Nuclear,0,18700538,18700538
2006,KS,Petroleum,102284,0,102284
2006,KS,Total,0,91047472,91047472
2006,KS,Wind,0,1983780,1983780
2006,KY,Coal,182396976,0,182396976
2006,KY,Hydroelectric Conventional,0,5183402,5183402
2006,KY,Natural Gas,2353276,0,2353276
2006,KY,Other,43310,0,43310
2006,KY,Other Biomass,178874,0,178874
2006,KY,Other Gases,7672,0,7672
2006,KY,Petroleum,6681796,0,6681796
2006,KY,Total,0,197584028,197584028
2006,KY,Wood and Wood Derived Fuels,738722,0,738722
2006,LA,Coal,48790410,0,48790410
2006,LA,Hydroelectric Conventional,0,1426430,1426430
2006,LA,Natural Gas,83866669,0,83866669
2006,LA,Nuclear,0,33470896,33470896
2006,LA,Other,1430984,0,1430984
2006,LA,Other Biomass,162864,0,162864
2006,LA,Other Gases,3189350,0,3189350
2006,LA,Petroleum,3744192,0,3744192
2006,LA,Total,0,181843659,181843659
2006,LA,Wood and Wood Derived Fuels,5761860,0,5761860
2006,MA,Coal,22276682,0,22276682
2006,MA,Hydroelectric Conventional,0,3025290,3025290
2006,MA,Natural Gas,46613352,0,46613352
2006,MA,Nuclear,0,11659316,11659316
2006,MA,Other,1564556,0,1564556
2006,MA,Other Biomass,2307142,0,2307142
2006,MA,Petroleum,4656492,0,4656492
2006,MA,Pumped Storage,0,-1157796,-1157796
2006,MA,Total,0,91195551,91195551
2006,MA,Wood and Wood Derived Fuels,250516,0,250516
2006,MD,Coal,58816044,0,58816044
2006,MD,Hydroelectric Conventional,0,4208550,4208550
2006,MD,Natural Gas,3540413,0,3540413
2006,MD,Nuclear,0,27660822,27660822
2006,MD,Other,609270,0,609270
2006,MD,Other Biomass,816190,0,816190
2006,MD,Other Gases,664887,0,664887
2006,MD,Petroleum,1161452,0,1161452
2006,MD,Total,0,97913760,97913760
2006,MD,Wood and Wood Derived Fuels,436132,0,436132
2006,ME,Coal,642524,0,642524
2006,ME,Hydroelectric Conventional,0,8556264,8556264
2006,ME,Natural Gas,14595712,0,14595712
2006,ME,Other,712673,0,712673
2006,ME,Other Biomass,566066,0,566066
2006,ME,Other Gases,0,0,0
2006,ME,Petroleum,1189870,0,1189870
2006,ME,Total,0,33632346,33632346
2006,ME,Wood and Wood Derived Fuels,7369236,0,7369236
2006,MI,Coal,135560321,0,135560321
2006,MI,Hydroelectric Conventional,0,3040706,3040706
2006,MI,Natural Gas,22819910,0,22819910
2006,MI,Nuclear,0,58132330,58132330
2006,MI,Other,1125044,0,1125044
2006,MI,Other Biomass,1473646,0,1473646
2006,MI,Other Gases,824694,0,824694
2006,MI,Petroleum,803775,0,803775
2006,MI,Pumped Storage,0,-2078420,-2078420
2006,MI,Total,0,225113477,225113477
2006,MI,Wind,0,4424,4424
2006,MI,Wood and Wood Derived Fuels,3407047,0,3407047
2006,MN,Coal,66140902,0,66140902
2006,MN,Hydroelectric Conventional,0,1143460,1143460
2006,MN,Natural Gas,5121593,0,5121593
2006,MN,Nuclear,0,26366836,26366836
2006,MN,Other,596640,0,596640
2006,MN,Other Biomass,828533,0,828533
2006,MN,Petroleum,988376,0,988376
2006,MN,Total,0,106475578,106475578
2006,MN,Wind,0,4109894,4109894
2006,MN,Wood and Wood Derived Fuels,1179340,0,1179340
2006,MO,Coal,154899208,0,154899208
2006,MO,Hydroelectric Conventional,0,398428,398428
2006,MO,Natural Gas,7458855,0,7458855
2006,MO,Nuclear,0,20233320,20233320
2006,MO,Other,107600,0,107600
2006,MO,Other Biomass,47750,0,47750
2006,MO,Other Gases,10182,0,10182
2006,MO,Petroleum,122049,0,122049
2006,MO,Pumped Storage,0,95104,95104
2006,MO,Total,0,183372687,183372687
2006,MO,Wood and Wood Derived Fuels,192,0,192
2006,MS,Coal,36210666,0,36210666
2006,MS,Natural Gas,31411698,0,31411698
2006,MS,Nuclear,0,20837172,20837172
2006,MS,Other,31132,0,31132
2006,MS,Other Biomass,12960,0,12960
2006,MS,Other Gases,87446,0,87446
2006,MS,Petroleum,797418,0,797418
2006,MS,Total,0,92457695,92457695
2006,MS,Wood and Wood Derived Fuels,3069204,0,3069204
2006,MT,Coal,34170160,0,34170160
2006,MT,Hydroelectric Conventional,0,20260322,20260322
2006,MT,Natural Gas,135160,0,135160
2006,MT,Other Gases,22414,0,22414
2006,MT,Petroleum,838248,0,838248
2006,MT,Total,0,56487073,56487073
2006,MT,Wind,0,871940,871940
2006,MT,Wood and Wood Derived Fuels,188830,0,188830
2006,NC,Coal,150974010,0,150974010
2006,NC,Hydroelectric Conventional,0,7678024,7678024
2006,NC,Natural Gas,6391126,0,6391126
2006,NC,Nuclear,0,79926368,79926368
2006,NC,Other,638471,0,638471
2006,NC,Other Biomass,183480,0,183480
2006,NC,Other Gases,0,0,0
2006,NC,Petroleum,902276,0,902276
2006,NC,Pumped Storage,0,262684,262684
2006,NC,Total,0,250429569,250429569
2006,NC,Wood and Wood Derived Fuels,3473130,0,3473130
2006,ND,Coal,57757982,0,57757982
2006,ND,Hydroelectric Conventional,0,3042068,3042068
2006,ND,Natural Gas,14130,0,14130
2006,ND,Other Biomass,7088,0,7088
2006,ND,Other Gases,117878,0,117878
2006,ND,Petroleum,84158,0,84158
2006,ND,Total,0,61762274,61762274
2006,ND,Wind,0,738970,738970
2006,NE,Coal,41365096,0,41365096
2006,NE,Hydroelectric Conventional,0,1786772,1786772
2006,NE,Natural Gas,1517602,0,1517602
2006,NE,Nuclear,0,18005312,18005312
2006,NE,Other Biomass,104028,0,104028
2006,NE,Other Gases,0,0,0
2006,NE,Petroleum,38634,0,38634
2006,NE,Total,0,63339937,63339937
2006,NE,Wind,0,522494,522494
2006,NH,Coal,7770866,0,7770866
2006,NH,Hydroelectric Conventional,0,3057820,3057820
2006,NH,Natural Gas,12013212,0,12013212
2006,NH,Nuclear,0,18795712,18795712
2006,NH,Other,118634,0,118634
2006,NH,Other Biomass,312798,0,312798
2006,NH,Petroleum,878386,0,878386
2006,NH,Total,0,44127390,44127390
2006,NH,Wood and Wood Derived Fuels,1179962,0,1179962
2006,NJ,Coal,21723850,0,21723850
2006,NJ,Hydroelectric Conventional,0,70872,70872
2006,NJ,Natural Gas,31336748,0,31336748
2006,NJ,Nuclear,0,65135770,65135770
2006,NJ,Other,1137102,0,1137102
2006,NJ,Other Biomass,1801585,0,1801585
2006,NJ,Other Gases,220530,0,220530
2006,NJ,Petroleum,539038,0,539038
2006,NJ,Pumped Storage,0,-597202,-597202
2006,NJ,Total,0,121400278,121400278
2006,NJ,Wind,0,31982,31982
2006,NM,Coal,59718016,0,59718016
2006,NM,Hydroelectric Conventional,0,396422,396422
2006,NM,Natural Gas,11779199,0,11779199
2006,NM,Other Biomass,43770,0,43770
2006,NM,Petroleum,82972,0,82972
2006,NM,Total,0,74531250,74531250
2006,NM,Wind,0,2510872,2510872
2006,NV,Coal,14507042,0,14507042
2006,NV,Geothermal,2687422,0,2687422
2006,NV,Hydroelectric Conventional,0,4115252,4115252
2006,NV,Natural Gas,42368270,0,42368270
2006,NV,Other Gases,7364,0,7364
2006,NV,Petroleum,34694,0,34694
2006,NV,Total,0,63720044,63720044
2006,NY,Coal,41935680,0,41935680
2006,NY,Hydroelectric Conventional,0,54689310,54689310
2006,NY,Natural Gas,84267756,0,84267756
2006,NY,Nuclear,0,84447798,84447798
2006,NY,Other,1953272,0,1953272
2006,NY,Other Biomass,2838882,0,2838882
2006,NY,Petroleum,13556079,0,13556079
2006,NY,Pumped Storage,0,-1512312,-1512312
2006,NY,Total,0,284530864,284530864
2006,NY,Wind,0,1310742,1310742
2006,NY,Wood and Wood Derived Fuels,1043658,0,1043658
2006,OH,Coal,266800312,0,266800312
2006,OH,Hydroelectric Conventional,0,1263872,1263872
2006,OH,Natural Gas,4758123,0,4758123
2006,OH,Nuclear,0,33693878,33693878
2006,OH,Other,5610,0,5610
2006,OH,Other Biomass,68242,0,68242
2006,OH,Other Gases,720014,0,720014
2006,OH,Petroleum,2709110,0,2709110
2006,OH,Total,0,310868150,310868150
2006,OH,Wind,0,28802,28802
2006,OH,Wood and Wood Derived Fuels,820185,0,820185
2006,OK,Coal,70064046,0,70064046
2006,OK,Hydroelectric Conventional,0,1247158,1247158
2006,OK,Natural Gas,65961380,0,65961380
2006,OK,Other,10890,0,10890
2006,OK,Other Biomass,0,0,0
2006,OK,Other Gases,32286,0,32286
2006,OK,Petroleum,127500,0,127500
2006,OK,Pumped Storage,0,-232946,-232946
2006,OK,Total,0,141229761,141229761
2006,OK,Wind,0,3424882,3424882
2006,OK,Wood and Wood Derived Fuels,594566,0,594566
2006,OR,Coal,4741256,0,4741256
2006,OR,Hydroelectric Conventional,0,75700594,75700594
2006,OR,Natural Gas,22477283,0,22477283
2006,OR,Other,80640,0,80640
2006,OR,Other Biomass,197953,0,197953
2006,OR,Petroleum,23640,0,23640
2006,OR,Total,0,106681390,106681390
2006,OR,Wind,0,1862438,1862438
2006,OR,Wood and Wood Derived Fuels,1597586,0,1597586
2006,PA,Coal,245115806,0,245115806
2006,PA,Hydroelectric Conventional,0,5688284,5688284
2006,PA,Natural Gas,27083457,0,27083457
2006,PA,Nuclear,0,150595264,150595264
2006,PA,Other,1445064,0,1445064
2006,PA,Other Biomass,2857416,0,2857416
2006,PA,Other Gases,1108864,0,1108864
2006,PA,Petroleum,3036914,0,3036914
2006,PA,Pumped Storage,0,-1396354,-1396354
2006,PA,Total,0,437623190,437623190
2006,PA,Wind,0,722216,722216
2006,PA,Wood and Wood Derived Fuels,1366260,0,1366260
2006,RI,Hydroelectric Conventional,0,11818,11818
2006,RI,Natural Gas,11560454,0,11560454
2006,RI,Other Biomass,297826,0,297826
2006,RI,Petroleum,65352,0,65352
2006,RI,Total,0,11935449,11935449
2006,SC,Coal,78945692,0,78945692
2006,SC,Hydroelectric Conventional,0,3613896,3613896
2006,SC,Natural Gas,12136122,0,12136122
2006,SC,Nuclear,0,101594744,101594744
2006,SC,Other,189816,0,189816
2006,SC,Other Biomass,212106,0,212106
2006,SC,Other Gases,32,0,32
2006,SC,Petroleum,473835,0,473835
2006,SC,Pumped Storage,0,-2239798,-2239798
2006,SC,Total,0,198535211,198535211
2006,SC,Wood and Wood Derived Fuels,3608768,0,3608768
2006,SD,Coal,6631822,0,6631822
2006,SD,Hydroelectric Conventional,0,6793666,6793666
2006,SD,Natural Gas,531634,0,531634
2006,SD,Other,114,0,114
2006,SD,Petroleum,9320,0,9320
2006,SD,Total,0,14264486,14264486
2006,SD,Wind,0,297930,297930
2006,TN,Coal,120995692,0,120995692
2006,TN,Hydroelectric Conventional,0,15497300,15497300
2006,TN,Natural Gas,1328548,0,1328548
2006,TN,Nuclear,0,49357554,49357554
2006,TN,Other,9274,0,9274
2006,TN,Other Biomass,116366,0,116366
2006,TN,Other Gases,27270,0,27270
2006,TN,Petroleum,320448,0,320448
2006,TN,Pumped Storage,0,-1335080,-1335080
2006,TN,Total,0,187822204,187822204
2006,TN,Wind,0,109196,109196
2006,TN,Wood and Wood Derived Fuels,1395638,0,1395638
2006,TX,Coal,292782682,0,292782682
2006,TX,Hydroelectric Conventional,0,1323942,1323942
2006,TX,Natural Gas,395740467,0,395740467
2006,TX,Nuclear,0,82528556,82528556
2006,TX,Other,1978417,0,1978417
2006,TX,Other Biomass,511402,0,511402
2006,TX,Other Gases,7596807,0,7596807
2006,TX,Petroleum,3578365,0,3578365
2006,TX,Total,0,801165756,801165756
2006,TX,Wind,0,13341030,13341030
2006,TX,Wood and Wood Derived Fuels,1784088,0,1784088
2006,UT,Coal,73711100,0,73711100
2006,UT,Geothermal,381216,0,381216
2006,UT,Hydroelectric Conventional,0,1493566,1493566
2006,UT,Natural Gas,6777100,0,6777100
2006,UT,Other,9676,0,9676
2006,UT,Other Biomass,29736,0,29736
2006,UT,Other Gases,0,0,0
2006,UT,Petroleum,124252,0,124252
2006,UT,Total,0,82526648,82526648
2006,VA,Coal,68576282,0,68576282
2006,VA,Hydroelectric Conventional,0,2702388,2702388
2006,VA,Natural Gas,14430899,0,14430899
2006,VA,Nuclear,0,55187032,55187032
2006,VA,Other,982038,0,982038
2006,VA,Other Biomass,1356815,0,1356815
2006,VA,Petroleum,1678424,0,1678424
2006,VA,Pumped Storage,0,-2334888,-2334888
2006,VA,Total,0,146139073,146139073
2006,VA,Wood and Wood Derived Fuels,3560086,0,3560086
2006,VT,Hydroelectric Conventional,0,3037330,3037330
2006,VT,Natural Gas,3750,0,3750
2006,VT,Nuclear,0,10213046,10213046
2006,VT,Petroleum,14742,0,14742
2006,VT,Total,0,14168688,14168688
2006,VT,Wind,0,21376,21376
2006,VT,Wood and Wood Derived Fuels,878444,0,878444
2006,WA,Coal,12745646,0,12745646
2006,WA,Hydroelectric Conventional,0,164015258,164015258
2006,WA,Natural Gas,14990819,0,14990819
2006,WA,Nuclear,0,18656554,18656554
2006,WA,Other,124370,0,124370
2006,WA,Other Biomass,368027,0,368027
2006,WA,Other Gases,697298,0,697298
2006,WA,Petroleum,76460,0,76460
2006,WA,Pumped Storage,0,94198,94198
2006,WA,Total,0,216406311,216406311
2006,WA,Wind,0,2075302,2075302
2006,WA,Wood and Wood Derived Fuels,2562378,0,2562378
2006,WI,Coal,80232980,0,80232980
2006,WI,Hydroelectric Conventional,0,3357196,3357196
2006,WI,Natural Gas,10716963,0,10716963
2006,WI,Nuclear,0,24467030,24467030
2006,WI,Other,219900,0,219900
2006,WI,Other Biomass,780769,0,780769
2006,WI,Petroleum,1754372,0,1754372
2006,WI,Total,0,123279686,123279686
2006,WI,Wind,0,202752,202752
2006,WI,Wood and Wood Derived Fuels,1547726,0,1547726
2006,WV,Coal,182946641,0,182946641
2006,WV,Hydroelectric Conventional,0,3144866,3144866
2006,WV,Natural Gas,723674,0,723674
2006,WV,Other,12956,0,12956
2006,WV,Other Biomass,592,0,592
2006,WV,Other Gases,105594,0,105594
2006,WV,Petroleum,349772,0,349772
2006,WV,Total,0,187631608,187631608
2006,WV,Wind,0,347514,347514
2006,WV,Wood and Wood Derived Fuels,0,0,0
2006,WY,Coal,85783654,0,85783654
2006,WY,Hydroelectric Conventional,0,1686632,1686632
2006,WY,Natural Gas,1002540,0,1002540
2006,WY,Other,98064,0,98064
2006,WY,Other Gases,619854,0,619854
2006,WY,Petroleum,91874,0,91874
2006,WY,Total,0,90800740,90800740
2006,WY,Wind,0,1518122,1518122
2007,AK,Coal,1282819,0,1282819
2007,AK,Hydroelectric Conventional,0,2582446,2582446
2007,AK,Natural Gas,7735079,0,7735079
2007,AK,Other Biomass,20392,0,20392
2007,AK,Petroleum,2019980,0,2019980
2007,AK,Total,0,13642784,13642784
2007,AK,Wind,0,2024,2024
2007,AK,Wood and Wood Derived Fuels,44,0,44
2007,AL,Coal,155987521,0,155987521
2007,AL,Hydroelectric Conventional,0,8272228,8272228
2007,AL,Natural Gas,46463552,0,46463552
2007,AL,Nuclear,0,68650254,68650254
2007,AL,Other,7166,0,7166
2007,AL,Other Biomass,33476,0,33476
2007,AL,Other Gases,356736,0,356736
2007,AL,Petroleum,313844,0,313844
2007,AL,Total,0,287652542,287652542
2007,AL,Wood and Wood Derived Fuels,7567764,0,7567764
2007,AR,Coal,51488360,0,51488360
2007,AR,Hydroelectric Conventional,0,6473506,6473506
2007,AR,Natural Gas,16728502,0,16728502
2007,AR,Nuclear,0,30972204,30972204
2007,AR,Other,34898,0,34898
2007,AR,Other Biomass,85882,0,85882
2007,AR,Petroleum,188306,0,188306
2007,AR,Pumped Storage,0,59208,59208
2007,AR,Total,0,109192471,109192471
2007,AR,Wood and Wood Derived Fuels,3161606,0,3161606
2007,AZ,Coal,82550724,0,82550724
2007,AZ,Hydroelectric Conventional,0,13195342,13195342
2007,AZ,Natural Gas,76938442,0,76938442
2007,AZ,Nuclear,0,53564782,53564782
2007,AZ,Other Biomass,65980,0,65980
2007,AZ,Petroleum,98552,0,98552
2007,AZ,Pumped Storage,0,250822,250822
2007,AZ,Solar Thermal and Photovoltaic,0,17298,17298
2007,AZ,Total,0,226681940,226681940
2007,CA,Coal,4596611,0,4596611
2007,CA,Geothermal,25981422,0,25981422
2007,CA,Hydroelectric Conventional,0,54655502,54655502
2007,CA,Natural Gas,231400942,0,231400942
2007,CA,Nuclear,0,71584980,71584980
2007,CA,Other,842895,0,842895
2007,CA,Other Biomass,4610456,0,4610456
2007,CA,Other Gases,3636213,0,3636213
2007,CA,Petroleum,4667948,0,4667948
2007,CA,Pumped Storage,0,619558,619558
2007,CA,Solar Thermal and Photovoltaic,0,1113938,1113938
2007,CA,Total,0,421695162,421695162
2007,CA,Wind,0,11169866,11169866
2007,CA,Wood and Wood Derived Fuels,6814832,0,6814832
2007,CO,Coal,71871478,0,71871478
2007,CO,Hydroelectric Conventional,0,3459066,3459066
2007,CO,Natural Gas,30027801,0,30027801
2007,CO,Other,82380,0,82380
2007,CO,Other Biomass,62210,0,62210
2007,CO,Other Gases,3822,0,3822
2007,CO,Petroleum,56900,0,56900
2007,CO,Pumped Storage,0,-336122,-336122
2007,CO,Solar Thermal and Photovoltaic,0,4416,4416
2007,CO,Total,0,107814985,107814985
2007,CO,Wind,0,2583032,2583032
2007,CO,Wood and Wood Derived Fuels,0,0,0
2007,CT,Coal,7477446,0,7477446
2007,CT,Hydroelectric Conventional,0,726522,726522
2007,CT,Natural Gas,19859119,0,19859119
2007,CT,Nuclear,0,32772284,32772284
2007,CT,Other,1451172,0,1451172
2007,CT,Other Biomass,1456328,0,1456328
2007,CT,Other Gases,4392,0,4392
2007,CT,Petroleum,2622518,0,2622518
2007,CT,Pumped Storage,0,-30710,-30710
2007,CT,Total,0,66342418,66342418
2007,CT,Wood and Wood Derived Fuels,3352,0,3352
2007,DC,Petroleum,150502,0,150502
2007,DC,Total,0,150502,150502
2007,DE,Coal,11243644,0,11243644
2007,DE,Natural Gas,3803967,0,3803967
2007,DE,Other Biomass,96232,0,96232
2007,DE,Other Gases,1442210,0,1442210
2007,DE,Petroleum,482273,0,482273
2007,DE,Total,0,17068326,17068326
2007,FL,Coal,135816230,0,135816230
2007,FL,Hydroelectric Conventional,0,308892,308892
2007,FL,Natural Gas,200614366,0,200614366
2007,FL,Nuclear,0,58578578,58578578
2007,FL,Other,6472359,0,6472359
2007,FL,Other Biomass,4746038,0,4746038
2007,FL,Other Gases,30324,0,30324
2007,FL,Petroleum,40405734,0,40405734
2007,FL,Total,0,450832119,450832119
2007,FL,Wood and Wood Derived Fuels,3859597,0,3859597
2007,GA,Coal,180595058,0,180595058
2007,GA,Hydroelectric Conventional,0,4472376,4472376
2007,GA,Natural Gas,32157888,0,32157888
2007,GA,Nuclear,0,65089996,65089996
2007,GA,Other,230998,0,230998
2007,GA,Other Biomass,106648,0,106648
2007,GA,Petroleum,1576454,0,1576454
2007,GA,Pumped Storage,0,-643298,-643298
2007,GA,Total,0,290310316,290310316
2007,GA,Wood and Wood Derived Fuels,6724194,0,6724194
2007,HI,Coal,3157862,0,3157862
2007,HI,Geothermal,459772,0,459772
2007,HI,Hydroelectric Conventional,0,184687,184687
2007,HI,Other,298590,0,298590
2007,HI,Other Biomass,570554,0,570554
2007,HI,Other Gases,90452,0,90452
2007,HI,Petroleum,17828414,0,17828414
2007,HI,Total,0,23066700,23066700
2007,HI,Wind,0,476368,476368
2007,IA,Coal,75971133,0,75971133
2007,IA,Hydroelectric Conventional,0,1924692,1924692
2007,IA,Natural Gas,6181758,0,6181758
2007,IA,Nuclear,0,9037750,9037750
2007,IA,Other,23722,0,23722
2007,IA,Other Biomass,302167,0,302167
2007,IA,Petroleum,623830,0,623830
2007,IA,Total,0,99578435,99578435
2007,IA,Wind,0,5513352,5513352
2007,IA,Wood and Wood Derived Fuels,32,0,32
2007,ID,Coal,167128,0,167128
2007,ID,Hydroelectric Conventional,0,18043380,18043380
2007,ID,Natural Gas,3314510,0,3314510
2007,ID,Other,137198,0,137198
2007,ID,Petroleum,268,0,268
2007,ID,Total,0,22968182,22968182
2007,ID,Wind,0,344534,344534
2007,ID,Wood and Wood Derived Fuels,961164,0,961164
2007,IL,Coal,190529827,0,190529827
2007,IL,Hydroelectric Conventional,0,307454,307454
2007,IL,Natural Gas,15083055,0,15083055
2007,IL,Nuclear,0,191457690,191457690
2007,IL,Other,41956,0,41956
2007,IL,Other Biomass,1240650,0,1240650
2007,IL,Other Gases,268541,0,268541
2007,IL,Petroleum,263334,0,263334
2007,IL,Total,0,400521362,400521362
2007,IL,Wind,0,1328854,1328854
2007,IN,Coal,245605794,0,245605794
2007,IN,Hydroelectric Conventional,0,899872,899872
2007,IN,Natural Gas,8023649,0,8023649
2007,IN,Other,761422,0,761422
2007,IN,Other Biomass,462494,0,462494
2007,IN,Other Gases,5182812,0,5182812
2007,IN,Petroleum,339953,0,339953
2007,IN,Total,0,261275997,261275997
2007,KS,Coal,72500526,0,72500526
2007,KS,Hydroelectric Conventional,0,21002,21002
2007,KS,Natural Gas,4265218,0,4265218
2007,KS,Nuclear,0,20738272,20738272
2007,KS,Petroleum,414298,0,414298
2007,KS,Total,0,100244391,100244391
2007,KS,Wind,0,2305076,2305076
2007,KY,Coal,180966119,0,180966119
2007,KY,Hydroelectric Conventional,0,3337174,3337174
2007,KY,Natural Gas,3592674,0,3592674
2007,KY,Other,31338,0,31338
2007,KY,Other Biomass,190826,0,190826
2007,KY,Other Gases,9490,0,9490
2007,KY,Petroleum,5582598,0,5582598
2007,KY,Total,0,194450638,194450638
2007,KY,Wood and Wood Derived Fuels,740420,0,740420
2007,LA,Coal,46102366,0,46102366
2007,LA,Hydroelectric Conventional,0,1653284,1653284
2007,LA,Natural Gas,87830029,0,87830029
2007,LA,Nuclear,0,34155144,34155144
2007,LA,Other,1332808,0,1332808
2007,LA,Other Biomass,163024,0,163024
2007,LA,Other Gases,3621994,0,3621994
2007,LA,Petroleum,4501266,0,4501266
2007,LA,Total,0,185156657,185156657
2007,LA,Wood and Wood Derived Fuels,5796742,0,5796742
2007,MA,Coal,24048694,0,24048694
2007,MA,Hydroelectric Conventional,0,1594964,1594964
2007,MA,Natural Gas,49850085,0,49850085
2007,MA,Nuclear,0,10239578,10239578
2007,MA,Other,1496066,0,1496066
2007,MA,Other Biomass,2242134,0,2242134
2007,MA,Petroleum,6103208,0,6103208
2007,MA,Pumped Storage,0,-1661094,-1661094
2007,MA,Total,0,94151950,94151950
2007,MA,Wood and Wood Derived Fuels,238314,0,238314
2007,MD,Coal,59398372,0,59398372
2007,MD,Hydroelectric Conventional,0,3304432,3304432
2007,MD,Natural Gas,4481854,0,4481854
2007,MD,Nuclear,0,28706384,28706384
2007,MD,Other,573101,0,573101
2007,MD,Other Biomass,800728,0,800728
2007,MD,Other Gases,755120,0,755120
2007,MD,Petroleum,1969662,0,1969662
2007,MD,Total,0,100395847,100395847
2007,MD,Wood and Wood Derived Fuels,406194,0,406194
2007,ME,Coal,751154,0,751154
2007,ME,Hydroelectric Conventional,0,7476335,7476335
2007,ME,Natural Gas,13349188,0,13349188
2007,ME,Other,629745,0,629745
2007,ME,Other Biomass,520686,0,520686
2007,ME,Petroleum,1636755,0,1636755
2007,ME,Total,0,32257135,32257135
2007,ME,Wind,0,198142,198142
2007,ME,Wood and Wood Derived Fuels,7695132,0,7695132
2007,MI,Coal,141621197,0,141621197
2007,MI,Hydroelectric Conventional,0,2539978,2539978
2007,MI,Natural Gas,26281969,0,26281969
2007,MI,Nuclear,0,63033906,63033906
2007,MI,Other,605932,0,605932
2007,MI,Other Biomass,1443644,0,1443644
2007,MI,Other Gases,564828,0,564828
2007,MI,Petroleum,1397050,0,1397050
2007,MI,Pumped Storage,0,-2258482,-2258482
2007,MI,Total,0,238619872,238619872
2007,MI,Wind,0,5446,5446
2007,MI,Wood and Wood Derived Fuels,3384404,0,3384404
2007,MN,Coal,64380745,0,64380745
2007,MN,Hydroelectric Conventional,0,1307644,1307644
2007,MN,Natural Gas,7684953,0,7684953
2007,MN,Nuclear,0,26206000,26206000
2007,MN,Other,649790,0,649790
2007,MN,Other Biomass,1132743,0,1132743
2007,MN,Other Gases,51688,0,51688
2007,MN,Petroleum,809198,0,809198
2007,MN,Total,0,108955293,108955293
2007,MN,Wind,0,5277624,5277624
2007,MN,Wood and Wood Derived Fuels,1454909,0,1454909
2007,MO,Coal,150168308,0,150168308
2007,MO,Hydroelectric Conventional,0,2408652,2408652
2007,MO,Natural Gas,9958758,0,9958758
2007,MO,Nuclear,0,18743910,18743910
2007,MO,Other,73370,0,73370
2007,MO,Other Biomass,58378,0,58378
2007,MO,Other Gases,6800,0,6800
2007,MO,Petroleum,120801,0,120801
2007,MO,Pumped Storage,0,766946,766946
2007,MO,Total,0,182306163,182306163
2007,MO,Wood and Wood Derived Fuels,240,0,240
2007,MS,Coal,34814649,0,34814649
2007,MS,Natural Gas,42670346,0,42670346
2007,MS,Nuclear,0,18717568,18717568
2007,MS,Other,14688,0,14688
2007,MS,Other Biomass,10034,0,10034
2007,MS,Other Gases,84650,0,84650
2007,MS,Petroleum,798740,0,798740
2007,MS,Total,0,100087373,100087373
2007,MS,Wood and Wood Derived Fuels,2976696,0,2976696
2007,MT,Coal,36713550,0,36713550
2007,MT,Hydroelectric Conventional,0,18728672,18728672
2007,MT,Natural Gas,211947,0,211947
2007,MT,Other Gases,38022,0,38022
2007,MT,Petroleum,957354,0,957354
2007,MT,Total,0,57862986,57862986
2007,MT,Wind,0,991552,991552
2007,MT,Wood and Wood Derived Fuels,221890,0,221890
2007,NC,Coal,159966077,0,159966077
2007,NC,Hydroelectric Conventional,0,5968318,5968318
2007,NC,Natural Gas,8913285,0,8913285
2007,NC,Nuclear,0,80089410,80089410
2007,NC,Other,683703,0,683703
2007,NC,Other Biomass,173690,0,173690
2007,NC,Other Gases,0,0,0
2007,NC,Petroleum,991379,0,991379
2007,NC,Pumped Storage,0,273992,273992
2007,NC,Total,0,260230602,260230602
2007,NC,Wood and Wood Derived Fuels,3170748,0,3170748
2007,ND,Coal,58327106,0,58327106
2007,ND,Hydroelectric Conventional,0,2610786,2610786
2007,ND,Natural Gas,33149,0,33149
2007,ND,Other,1946,0,1946
2007,ND,Other Biomass,27014,0,27014
2007,ND,Other Gases,105030,0,105030
2007,ND,Petroleum,101636,0,101636
2007,ND,Total,0,62448210,62448210
2007,ND,Wind,0,1241544,1241544
2007,NE,Coal,39259822,0,39259822
2007,NE,Hydroelectric Conventional,0,694888,694888
2007,NE,Natural Gas,2220040,0,2220040
2007,NE,Nuclear,0,22083064,22083064
2007,NE,Other Biomass,122518,0,122518
2007,NE,Other Gases,0,0,0
2007,NE,Petroleum,71534,0,71534
2007,NE,Total,0,64885398,64885398
2007,NE,Wind,0,433530,433530
2007,NH,Coal,7854830,0,7854830
2007,NH,Hydroelectric Conventional,0,2530458,2530458
2007,NH,Natural Gas,11508029,0,11508029
2007,NH,Nuclear,0,21527768,21527768
2007,NH,Other,117122,0,117122
2007,NH,Other Biomass,305632,0,305632
2007,NH,Petroleum,769590,0,769590
2007,NH,Total,0,46554342,46554342
2007,NH,Wood and Wood Derived Fuels,1940913,0,1940913
2007,NJ,Coal,20421340,0,20421340
2007,NJ,Hydroelectric Conventional,0,41818,41818
2007,NJ,Natural Gas,37504663,0,37504663
2007,NJ,Nuclear,0,64020752,64020752
2007,NJ,Other,977988,0,977988
2007,NJ,Other Biomass,1646332,0,1646332
2007,NJ,Other Gases,321099,0,321099
2007,NJ,Petroleum,905543,0,905543
2007,NJ,Pumped Storage,0,-537868,-537868
2007,NJ,Total,0,125342490,125342490
2007,NJ,Wind,0,40824,40824
2007,NM,Coal,55207294,0,55207294
2007,NM,Hydroelectric Conventional,0,535956,535956
2007,NM,Natural Gas,13320008,0,13320008
2007,NM,Other Biomass,31988,0,31988
2007,NM,Petroleum,88942,0,88942
2007,NM,Total,0,71970666,71970666
2007,NM,Wind,0,2786478,2786478
2007,NV,Coal,14181822,0,14181822
2007,NV,Geothermal,2505382,0,2505382
2007,NV,Hydroelectric Conventional,0,4006382,4006382
2007,NV,Natural Gas,44526540,0,44526540
2007,NV,Other Gases,8512,0,8512
2007,NV,Petroleum,22900,0,22900
2007,NV,Solar Thermal and Photovoltaic,0,87934,87934
2007,NV,Total,0,65339472,65339472
2007,NY,Coal,42811084,0,42811084
2007,NY,Hydroelectric Conventional,0,50505111,50505111
2007,NY,Natural Gas,91267262,0,91267262
2007,NY,Nuclear,0,84905708,84905708
2007,NY,Other,1864584,0,1864584
2007,NY,Other Biomass,2898692,0,2898692
2007,NY,Petroleum,16390218,0,16390218
2007,NY,Pumped Storage,0,-1536760,-1536760
2007,NY,Total,0,291757375,291757375
2007,NY,Wind,0,1666952,1666952
2007,NY,Wood and Wood Derived Fuels,984522,0,984522
2007,OH,Coal,266261358,0,266261358
2007,OH,Hydroelectric Conventional,0,820872,820872
2007,OH,Natural Gas,7949795,0,7949795
2007,OH,Nuclear,0,31528098,31528098
2007,OH,Other,6644,0,6644
2007,OH,Other Biomass,42034,0,42034
2007,OH,Other Gases,578546,0,578546
2007,OH,Petroleum,2295491,0,2295491
2007,OH,Total,0,310311090,310311090
2007,OH,Wind,0,29496,29496
2007,OH,Wood and Wood Derived Fuels,798757,0,798757
2007,OK,Coal,68875874,0,68875874
2007,OK,Hydroelectric Conventional,0,6131724,6131724
2007,OK,Natural Gas,66287822,0,66287822
2007,OK,Other,50538,0,50538
2007,OK,Other Biomass,7442,0,7442
2007,OK,Other Gases,44948,0,44948
2007,OK,Petroleum,320975,0,320975
2007,OK,Pumped Storage,0,-331688,-331688
2007,OK,Total,0,145638190,145638190
2007,OK,Wind,0,3698288,3698288
2007,OK,Wood and Wood Derived Fuels,552266,0,552266
2007,OR,Coal,8703248,0,8703248
2007,OR,Hydroelectric Conventional,0,67174878,67174878
2007,OR,Natural Gas,29715335,0,29715335
2007,OR,Other,76966,0,76966
2007,OR,Other Biomass,277467,0,277467
2007,OR,Petroleum,28574,0,28574
2007,OR,Total,0,110155588,110155588
2007,OR,Wind,0,2493988,2493988
2007,OR,Wood and Wood Derived Fuels,1685131,0,1685131
2007,PA,Coal,245386188,0,245386188
2007,PA,Hydroelectric Conventional,0,4471964,4471964
2007,PA,Natural Gas,38395199,0,38395199
2007,PA,Nuclear,0,154752632,154752632
2007,PA,Other,1487897,0,1487897
2007,PA,Other Biomass,2913221,0,2913221
2007,PA,Other Gases,1067972,0,1067972
2007,PA,Petroleum,2968147,0,2968147
2007,PA,Pumped Storage,0,-1445710,-1445710
2007,PA,Total,0,452176680,452176680
2007,PA,Wind,0,940036,940036
2007,PA,Wood and Wood Derived Fuels,1239133,0,1239133
2007,RI,Hydroelectric Conventional,0,8728,8728
2007,RI,Natural Gas,13713544,0,13713544
2007,RI,Other Biomass,309514,0,309514
2007,RI,Petroleum,67902,0,67902
2007,RI,Total,0,14099688,14099688
2007,SC,Coal,83165339,0,83165339
2007,SC,Hydroelectric Conventional,0,3111824,3111824
2007,SC,Natural Gas,11929116,0,11929116
2007,SC,Nuclear,0,106399828,106399828
2007,SC,Other,192732,0,192732
2007,SC,Other Biomass,201204,0,201204
2007,SC,Other Gases,30,0,30
2007,SC,Petroleum,434575,0,434575
2007,SC,Pumped Storage,0,-2421228,-2421228
2007,SC,Total,0,206804283,206804283
2007,SC,Wood and Wood Derived Fuels,3790864,0,3790864
2007,SD,Coal,5310668,0,5310668
2007,SD,Hydroelectric Conventional,0,5834566,5834566
2007,SD,Natural Gas,702084,0,702084
2007,SD,Other,52,0,52
2007,SD,Petroleum,125804,0,125804
2007,SD,Total,0,12273210,12273210
2007,SD,Wind,0,300036,300036
2007,TN,Coal,120474660,0,120474660
2007,TN,Hydroelectric Conventional,0,9879202,9879202
2007,TN,Natural Gas,1443676,0,1443676
2007,TN,Nuclear,0,57400742,57400742
2007,TN,Other,5040,0,5040
2007,TN,Other Biomass,104960,0,104960
2007,TN,Other Gases,26976,0,26976
2007,TN,Petroleum,464196,0,464196
2007,TN,Pumped Storage,0,-1408728,-1408728
2007,TN,Total,0,190226818,190226818
2007,TN,Wind,0,99874,99874
2007,TN,Wood and Wood Derived Fuels,1736220,0,1736220
2007,TX,Coal,294557778,0,294557778
2007,TX,Hydroelectric Conventional,0,3288874,3288874
2007,TX,Natural Gas,399062561,0,399062561
2007,TX,Nuclear,0,81910060,81910060
2007,TX,Other,1769864,0,1769864
2007,TX,Other Biomass,734130,0,734130
2007,TX,Other Gases,7202422,0,7202422
2007,TX,Petroleum,2617806,0,2617806
2007,TX,Total,0,810984592,810984592
2007,TX,Wind,0,18012766,18012766
2007,TX,Wood and Wood Derived Fuels,1828328,0,1828328
2007,UT,Coal,74341588,0,74341588
2007,UT,Geothermal,327850,0,327850
2007,UT,Hydroelectric Conventional,0,1077564,1077564
2007,UT,Natural Gas,14848435,0,14848435
2007,UT,Other,9358,0,9358
2007,UT,Other Biomass,62060,0,62060
2007,UT,Other Gases,0,0,0
2007,UT,Petroleum,78294,0,78294
2007,UT,Total,0,90745150,90745150
2007,VA,Coal,70841492,0,70841492
2007,VA,Hydroelectric Conventional,0,2496528,2496528
2007,VA,Natural Gas,21807680,0,21807680
2007,VA,Nuclear,0,54536950,54536950
2007,VA,Other,953890,0,953890
2007,VA,Other Biomass,1546490,0,1546490
2007,VA,Petroleum,4193899,0,4193899
2007,VA,Pumped Storage,0,-3240566,-3240566
2007,VA,Total,0,156721013,156721013
2007,VA,Wood and Wood Derived Fuels,3584652,0,3584652
2007,VT,Hydroelectric Conventional,0,1293210,1293210
2007,VT,Natural Gas,3778,0,3778
2007,VT,Nuclear,0,9407456,9407456
2007,VT,Petroleum,15622,0,15622
2007,VT,Total,0,11647164,11647164
2007,VT,Wind,0,21022,21022
2007,VT,Wood and Wood Derived Fuels,906076,0,906076
2007,WA,Coal,17113633,0,17113633
2007,WA,Hydroelectric Conventional,0,157658391,157658391
2007,WA,Natural Gas,14574788,0,14574788
2007,WA,Nuclear,0,16217120,16217120
2007,WA,Other,124740,0,124740
2007,WA,Other Biomass,352702,0,352702
2007,WA,Other Gases,667546,0,667546
2007,WA,Petroleum,74084,0,74084
2007,WA,Pumped Storage,0,89024,89024
2007,WA,Total,0,213980434,213980434
2007,WA,Wind,0,4875646,4875646
2007,WA,Wood and Wood Derived Fuels,2232760,0,2232760
2007,WI,Coal,80056500,0,80056500
2007,WI,Hydroelectric Conventional,0,3032166,3032166
2007,WI,Natural Gas,12977501,0,12977501
2007,WI,Nuclear,0,25820638,25820638
2007,WI,Other,208594,0,208594
2007,WI,Other Biomass,870311,0,870311
2007,WI,Petroleum,2026828,0,2026828
2007,WI,Total,0,126781260,126781260
2007,WI,Wind,0,218566,218566
2007,WI,Wood and Wood Derived Fuels,1570158,0,1570158
2007,WV,Coal,183732530,0,183732530
2007,WV,Hydroelectric Conventional,0,2508794,2508794
2007,WV,Natural Gas,777589,0,777589
2007,WV,Other,942,0,942
2007,WV,Other Biomass,0,0,0
2007,WV,Other Gases,111352,0,111352
2007,WV,Petroleum,399838,0,399838
2007,WV,Total,0,187866219,187866219
2007,WV,Wind,0,335176,335176
2007,WV,Wood and Wood Derived Fuels,0,0,0
2007,WY,Coal,86253618,0,86253618
2007,WY,Hydroelectric Conventional,0,1458848,1458848
2007,WY,Natural Gas,1188052,0,1188052
2007,WY,Other,138068,0,138068
2007,WY,Other Gases,624182,0,624182
2007,WY,Petroleum,94444,0,94444
2007,WY,Total,0,91266972,91266972
2007,WY,Wind,0,1509762,1509762
2008,AK,Coal,1235793,0,1235793
2008,AK,Hydroelectric Conventional,0,2343602,2343602
2008,AK,Natural Gas,8004944,0,8004944
2008,AK,Other,0,0,0
2008,AK,Other Biomass,9364,0,9364
2008,AK,Petroleum,1955830,0,1955830
2008,AK,Total,0,13549669,13549669
2008,AK,Wind,0,136,136
2008,AK,Wood and Wood Derived Fuels,0,0,0
2008,AL,Coal,149209296,0,149209296
2008,AL,Hydroelectric Conventional,0,12272296,12272296
2008,AL,Natural Gas,44725838,0,44725838
2008,AL,Nuclear,0,77985282,77985282
2008,AL,Other,16444,0,16444
2008,AL,Other Biomass,67396,0,67396
2008,AL,Other Gases,407478,0,407478
2008,AL,Petroleum,408530,0,408530
2008,AL,Total,0,291739790,291739790
2008,AL,Wood and Wood Derived Fuels,6647232,0,6647232
2008,AR,Coal,52229308,0,52229308
2008,AR,Hydroelectric Conventional,0,9320594,9320594
2008,AR,Natural Gas,16922146,0,16922146
2008,AR,Nuclear,0,28336182,28336182
2008,AR,Other,44794,0,44794
2008,AR,Other Biomass,93540,0,93540
2008,AR,Petroleum,127250,0,127250
2008,AR,Pumped Storage,0,95114,95114
2008,AR,Total,0,110101055,110101055
2008,AR,Wood and Wood Derived Fuels,2932126,0,2932126
2008,AZ,Coal,87680520,0,87680520
2008,AZ,Hydroelectric Conventional,0,14571804,14571804
2008,AZ,Natural Gas,77644858,0,77644858
2008,AZ,Nuclear,0,58500992,58500992
2008,AZ,Other Biomass,45972,0,45972
2008,AZ,Petroleum,103795,0,103795
2008,AZ,Pumped Storage,0,189060,189060
2008,AZ,Solar Thermal and Photovoltaic,0,29448,29448
2008,AZ,Total,0,238918344,238918344
2008,AZ,Wood and Wood Derived Fuels,151894,0,151894
2008,CA,Coal,4560802,0,4560802
2008,CA,Geothermal,25766000,0,25766000
2008,CA,Hydroelectric Conventional,0,48255619,48255619
2008,CA,Natural Gas,239983475,0,239983475
2008,CA,Nuclear,0,64964702,64964702
2008,CA,Other,1140622,0,1140622
2008,CA,Other Biomass,4723892,0,4723892
2008,CA,Other Gases,3369726,0,3369726
2008,CA,Petroleum,3483181,0,3483181
2008,CA,Pumped Storage,0,642526,642526
2008,CA,Solar Thermal and Photovoltaic,0,1340962,1340962
2008,CA,Total,0,415968526,415968526
2008,CA,Wind,0,10769910,10769910
2008,CA,Wood and Wood Derived Fuels,6967110,0,6967110
2008,CO,Coal,69655090,0,69655090
2008,CO,Hydroelectric Conventional,0,4078654,4078654
2008,CO,Natural Gas,26974950,0,26974950
2008,CO,Other,65582,0,65582
2008,CO,Other Biomass,90238,0,90238
2008,CO,Other Gases,0,0,0
2008,CO,Petroleum,38225,0,38225
2008,CO,Pumped Storage,0,-498216,-498216
2008,CO,Solar Thermal and Photovoltaic,0,36708,36708
2008,CO,Total,0,106883187,106883187
2008,CO,Wind,0,6441686,6441686
2008,CO,Wood and Wood Derived Fuels,270,0,270
2008,CT,Coal,8773216,0,8773216
2008,CT,Hydroelectric Conventional,0,1112354,1112354
2008,CT,Natural Gas,16139704,0,16139704
2008,CT,Nuclear,0,30865892,30865892
2008,CT,Other,1419468,0,1419468
2008,CT,Other Biomass,1463762,0,1463762
2008,CT,Other Gases,0,0,0
2008,CT,Petroleum,1027700,0,1027700
2008,CT,Pumped Storage,0,13582,13582
2008,CT,Total,0,60818945,60818945
2008,CT,Wood and Wood Derived Fuels,3266,0,3266
2008,DC,Petroleum,144632,0,144632
2008,DC,Total,0,144632,144632
2008,DE,Coal,10533830,0,10533830
2008,DE,Natural Gas,2774018,0,2774018
2008,DE,Other,21882,0,21882
2008,DE,Other Biomass,326750,0,326750
2008,DE,Other Gases,952844,0,952844
2008,DE,Petroleum,438354,0,438354
2008,DE,Total,0,15047678,15047678
2008,FL,Coal,129646822,0,129646822
2008,FL,Hydroelectric Conventional,0,412316,412316
2008,FL,Natural Gas,206726246,0,206726246
2008,FL,Nuclear,0,64266552,64266552
2008,FL,Other,5654526,0,5654526
2008,FL,Other Biomass,4668254,0,4668254
2008,FL,Other Gases,19954,0,19954
2008,FL,Petroleum,23941485,0,23941485
2008,FL,Total,0,439273637,439273637
2008,FL,Wood and Wood Derived Fuels,3937482,0,3937482
2008,GA,Coal,170982515,0,170982515
2008,GA,Hydroelectric Conventional,0,4289236,4289236
2008,GA,Natural Gas,26856822,0,26856822
2008,GA,Nuclear,0,63382190,63382190
2008,GA,Other,102808,0,102808
2008,GA,Other Biomass,243370,0,243370
2008,GA,Petroleum,1483123,0,1483123
2008,GA,Pumped Storage,0,-313844,-313844
2008,GA,Total,0,272346791,272346791
2008,GA,Wood and Wood Derived Fuels,5320570,0,5320570
2008,HI,Coal,3295184,0,3295184
2008,HI,Geothermal,468666,0,468666
2008,HI,Hydroelectric Conventional,0,168686,168686
2008,HI,Other,318292,0,318292
2008,HI,Other Biomass,604847,0,604847
2008,HI,Other Gases,77144,0,77144
2008,HI,Petroleum,17339869,0,17339869
2008,HI,Solar Thermal and Photovoltaic,0,36,36
2008,HI,Total,0,22752770,22752770
2008,HI,Wind,0,480046,480046
2008,IA,Coal,80820214,0,80820214
2008,IA,Hydroelectric Conventional,0,1638094,1638094
2008,IA,Natural Gas,4326382,0,4326382
2008,IA,Nuclear,0,10564404,10564404
2008,IA,Other,26,0,26
2008,IA,Other Biomass,334528,0,334528
2008,IA,Petroleum,322254,0,322254
2008,IA,Total,0,106173572,106173572
2008,IA,Wind,0,8167574,8167574
2008,IA,Wood and Wood Derived Fuels,98,0,98
2008,ID,Coal,180898,0,180898
2008,ID,Geothermal,171094,0,171094
2008,ID,Hydroelectric Conventional,0,18725002,18725002
2008,ID,Natural Gas,3399106,0,3399106
2008,ID,Other,139034,0,139034
2008,ID,Petroleum,240,0,240
2008,ID,Total,0,23941106,23941106
2008,ID,Wind,0,414944,414944
2008,ID,Wood and Wood Derived Fuels,910786,0,910786
2008,IL,Coal,193288077,0,193288077
2008,IL,Hydroelectric Conventional,0,277098,277098
2008,IL,Natural Gas,8519739,0,8519739
2008,IL,Nuclear,0,190303388,190303388
2008,IL,Other,98896,0,98896
2008,IL,Other Biomass,1394740,0,1394740
2008,IL,Other Gases,107748,0,107748
2008,IL,Petroleum,285456,0,285456
2008,IL,Total,0,398950357,398950357
2008,IL,Wind,0,4673992,4673992
2008,IL,Wood and Wood Derived Fuels,1224,0,1224
2008,IN,Coal,244072171,0,244072171
2008,IN,Hydroelectric Conventional,0,873560,873560
2008,IN,Natural Gas,7272607,0,7272607
2008,IN,Other,711368,0,711368
2008,IN,Other Biomass,546075,0,546075
2008,IN,Other Gases,4711608,0,4711608
2008,IN,Petroleum,356489,0,356489
2008,IN,Total,0,259020588,259020588
2008,IN,Wind,0,476712,476712
2008,KS,Coal,68006524,0,68006524
2008,KS,Hydroelectric Conventional,0,21148,21148
2008,KS,Natural Gas,4459446,0,4459446
2008,KS,Nuclear,0,16994320,16994320
2008,KS,Petroleum,260380,0,260380
2008,KS,Total,0,93260642,93260642
2008,KS,Wind,0,3518824,3518824
2008,KY,Coal,183241176,0,183241176
2008,KY,Hydroelectric Conventional,0,3834940,3834940
2008,KY,Natural Gas,1957384,0,1957384
2008,KY,Other,17394,0,17394
2008,KY,Other Biomass,217760,0,217760
2008,KY,Other Gases,7670,0,7670
2008,KY,Petroleum,5748879,0,5748879
2008,KY,Total,0,195726680,195726680
2008,KY,Wood and Wood Derived Fuels,701480,0,701480
2008,LA,Coal,48200083,0,48200083
2008,LA,Hydroelectric Conventional,0,2128746,2128746
2008,LA,Natural Gas,90688772,0,90688772
2008,LA,Nuclear,0,30741976,30741976
2008,LA,Other,915214,0,915214
2008,LA,Other Biomass,141772,0,141772
2008,LA,Other Gases,2202114,0,2202114
2008,LA,Petroleum,4610027,0,4610027
2008,LA,Total,0,184906283,184906283
2008,LA,Wood and Wood Derived Fuels,5277578,0,5277578
2008,MA,Coal,21257377,0,21257377
2008,MA,Hydroelectric Conventional,0,2311622,2311622
2008,MA,Natural Gas,43028868,0,43028868
2008,MA,Nuclear,0,11737278,11737278
2008,MA,Other,1545856,0,1545856
2008,MA,Other Biomass,2258092,0,2258092
2008,MA,Petroleum,4215999,0,4215999
2008,MA,Pumped Storage,0,-1596800,-1596800
2008,MA,Solar Thermal and Photovoltaic,0,160,160
2008,MA,Total,0,85010956,85010956
2008,MA,Wind,0,7344,7344
2008,MA,Wood and Wood Derived Fuels,245160,0,245160
2008,MD,Coal,54436477,0,54436477
2008,MD,Hydroelectric Conventional,0,3948156,3948156
2008,MD,Natural Gas,3696294,0,3696294
2008,MD,Nuclear,0,29357390,29357390
2008,MD,Other,571291,0,571291
2008,MD,Other Biomass,829561,0,829561
2008,MD,Other Gases,675646,0,675646
2008,MD,Petroleum,811680,0,811680
2008,MD,Total,0,94721906,94721906
2008,MD,Wood and Wood Derived Fuels,395408,0,395408
2008,ME,Coal,703598,0,703598
2008,ME,Hydroelectric Conventional,0,8914810,8914810
2008,ME,Natural Gas,14759230,0,14759230
2008,ME,Other,630262,0,630262
2008,ME,Other Biomass,515589,0,515589
2008,ME,Petroleum,1065970,0,1065970
2008,ME,Total,0,34189839,34189839
2008,ME,Wind,0,263242,263242
2008,ME,Wood and Wood Derived Fuels,7337138,0,7337138
2008,MI,Coal,139710872,0,139710872
2008,MI,Hydroelectric Conventional,0,2728756,2728756
2008,MI,Natural Gas,19204074,0,19204074
2008,MI,Nuclear,0,62968856,62968856
2008,MI,Other,571883,0,571883
2008,MI,Other Biomass,1479074,0,1479074
2008,MI,Other Gases,528814,0,528814
2008,MI,Petroleum,915078,0,915078
2008,MI,Pumped Storage,0,-1831004,-1831004
2008,MI,Total,0,229979612,229979612
2008,MI,Wind,0,282364,282364
2008,MI,Wood and Wood Derived Fuels,3420847,0,3420847
2008,MN,Coal,63510506,0,63510506
2008,MN,Hydroelectric Conventional,0,1454122,1454122
2008,MN,Natural Gas,5731692,0,5731692
2008,MN,Nuclear,0,25993676,25993676
2008,MN,Other,618685,0,618685
2008,MN,Other Biomass,1542084,0,1542084
2008,MN,Other Gases,53040,0,53040
2008,MN,Petroleum,463235,0,463235
2008,MN,Total,0,109526720,109526720
2008,MN,Wind,0,8709240,8709240
2008,MN,Wood and Wood Derived Fuels,1450440,0,1450440
2008,MO,Coal,147063321,0,147063321
2008,MO,Hydroelectric Conventional,0,4093546,4093546
2008,MO,Natural Gas,10392273,0,10392273
2008,MO,Nuclear,0,18757258,18757258
2008,MO,Other,48416,0,48416
2008,MO,Other Biomass,82199,0,82199
2008,MO,Other Gases,5174,0,5174
2008,MO,Petroleum,114842,0,114842
2008,MO,Pumped Storage,0,1090710,1090710
2008,MO,Total,0,182057590,182057590
2008,MO,Wind,0,406626,406626
2008,MO,Wood and Wood Derived Fuels,3226,0,3226
2008,MS,Coal,33366804,0,33366804
2008,MS,Natural Gas,41214854,0,41214854
2008,MS,Nuclear,0,18793580,18793580
2008,MS,Other,20080,0,20080
2008,MS,Other Biomass,10102,0,10102
2008,MS,Other Gases,80890,0,80890
2008,MS,Petroleum,152562,0,152562
2008,MS,Total,0,96411421,96411421
2008,MS,Wood and Wood Derived Fuels,2772550,0,2772550
2008,MT,Coal,36663065,0,36663065
2008,MT,Hydroelectric Conventional,0,19999114,19999114
2008,MT,Natural Gas,131317,0,131317
2008,MT,Other,222742,0,222742
2008,MT,Other Gases,11544,0,11544
2008,MT,Petroleum,838300,0,838300
2008,MT,Total,0,59274274,59274274
2008,MT,Wind,0,1186276,1186276
2008,MT,Wood and Wood Derived Fuels,221916,0,221916
2008,NC,Coal,151629573,0,151629573
2008,NC,Hydroelectric Conventional,0,6067284,6067284
2008,NC,Natural Gas,8354684,0,8354684
2008,NC,Nuclear,0,79552560,79552560
2008,NC,Other,631284,0,631284
2008,NC,Other Biomass,240964,0,240964
2008,NC,Other Gases,0,0,0
2008,NC,Petroleum,640442,0,640442
2008,NC,Pumped Storage,0,-242128,-242128
2008,NC,Solar Thermal and Photovoltaic,0,3602,3602
2008,NC,Total,0,250478125,250478125
2008,NC,Wood and Wood Derived Fuels,3599860,0,3599860
2008,ND,Coal,59344460,0,59344460
2008,ND,Hydroelectric Conventional,0,2505580,2505580
2008,ND,Natural Gas,-102,0,-102
2008,ND,Other,108266,0,108266
2008,ND,Other Biomass,25854,0,25854
2008,ND,Other Gases,0,0,0
2008,ND,Petroleum,98184,0,98184
2008,ND,Total,0,65469158,65469158
2008,ND,Wind,0,3386916,3386916
2008,NE,Coal,42959545,0,42959545
2008,NE,Hydroelectric Conventional,0,692912,692912
2008,NE,Natural Gas,1516975,0,1516975
2008,NE,Nuclear,0,18958078,18958078
2008,NE,Other Biomass,121857,0,121857
2008,NE,Other Gases,0,0,0
2008,NE,Petroleum,69310,0,69310
2008,NE,Total,0,64747044,64747044
2008,NE,Wind,0,428368,428368
2008,NH,Coal,6901540,0,6901540
2008,NH,Hydroelectric Conventional,0,3266448,3266448
2008,NH,Natural Gas,14146702,0,14146702
2008,NH,Nuclear,0,18700628,18700628
2008,NH,Other,116136,0,116136
2008,NH,Other Biomass,310050,0,310050
2008,NH,Petroleum,272563,0,272563
2008,NH,Total,0,45753983,45753983
2008,NH,Wind,0,20638,20638
2008,NH,Wood and Wood Derived Fuels,2019280,0,2019280
2008,NJ,Coal,18056981,0,18056981
2008,NJ,Hydroelectric Conventional,0,51546,51546
2008,NJ,Natural Gas,41503509,0,41503509
2008,NJ,Nuclear,0,64389596,64389596
2008,NJ,Other,1118780,0,1118780
2008,NJ,Other Biomass,1763472,0,1763472
2008,NJ,Other Gases,317652,0,317652
2008,NJ,Petroleum,650624,0,650624
2008,NJ,Pumped Storage,0,-549690,-549690
2008,NJ,Solar Thermal and Photovoltaic,0,5338,5338
2008,NJ,Total,0,127349578,127349578
2008,NJ,Wind,0,41770,41770
2008,NM,Coal,54028466,0,54028466
2008,NM,Hydroelectric Conventional,0,624576,624576
2008,NM,Natural Gas,15932013,0,15932013
2008,NM,Other,6098,0,6098
2008,NM,Other Biomass,37770,0,37770
2008,NM,Petroleum,105177,0,105177
2008,NM,Total,0,74019674,74019674
2008,NM,Wind,0,3285574,3285574
2008,NV,Coal,15624705,0,15624705
2008,NV,Geothermal,2765640,0,2765640
2008,NV,Hydroelectric Conventional,0,3501240,3501240
2008,NV,Natural Gas,47943823,0,47943823
2008,NV,Other Gases,3974,0,3974
2008,NV,Petroleum,28541,0,28541
2008,NV,Solar Thermal and Photovoltaic,0,312026,312026
2008,NV,Total,0,70179948,70179948
2008,NY,Coal,38308250,0,38308250
2008,NY,Hydroelectric Conventional,0,53446262,53446262
2008,NY,Natural Gas,87712920,0,87712920
2008,NY,Nuclear,0,86418342,86418342
2008,NY,Other,1974732,0,1974732
2008,NY,Other Biomass,3025720,0,3025720
2008,NY,Petroleum,7490656,0,7490656
2008,NY,Pumped Storage,0,-1344278,-1344278
2008,NY,Total,0,280644201,280644201
2008,NY,Wind,0,2501400,2501400
2008,NY,Wood and Wood Derived Fuels,1110193,0,1110193
2008,OH,Coal,261388620,0,261388620
2008,OH,Hydroelectric Conventional,0,772870,772870
2008,OH,Natural Gas,4968783,0,4968783
2008,OH,Nuclear,0,35027756,35027756
2008,OH,Other,22000,0,22000
2008,OH,Other Biomass,380350,0,380350
2008,OH,Other Gases,521848,0,521848
2008,OH,Petroleum,2875875,0,2875875
2008,OH,Total,0,306824502,306824502
2008,OH,Wind,0,30168,30168
2008,OH,Wood and Wood Derived Fuels,836234,0,836234
2008,OK,Coal,72629835,0,72629835
2008,OK,Hydroelectric Conventional,0,7622546,7622546
2008,OK,Natural Gas,67548334,0,67548334
2008,OK,Other,25382,0,25382
2008,OK,Other Biomass,339236,0,339236
2008,OK,Other Gases,20438,0,20438
2008,OK,Petroleum,45071,0,45071
2008,OK,Pumped Storage,0,-335196,-335196
2008,OK,Total,0,152657817,152657817
2008,OK,Wind,0,4716160,4716160
2008,OK,Wood and Wood Derived Fuels,46012,0,46012
2008,OR,Coal,8088638,0,8088638
2008,OR,Hydroelectric Conventional,0,67610048,67610048
2008,OR,Natural Gas,34774324,0,34774324
2008,OR,Other,88084,0,88084
2008,OR,Other Biomass,261494,0,261494
2008,OR,Other Gases,0,0,0
2008,OR,Petroleum,29586,0,29586
2008,OR,Total,0,117436876,117436876
2008,OR,Wind,0,5150468,5150468
2008,OR,Wood and Wood Derived Fuels,1434234,0,1434234
2008,PA,Coal,235166823,0,235166823
2008,PA,Hydroelectric Conventional,0,5097716,5097716
2008,PA,Natural Gas,37461214,0,37461214
2008,PA,Nuclear,0,157316186,157316186
2008,PA,Other,1664708,0,1664708
2008,PA,Other Biomass,2832402,0,2832402
2008,PA,Other Gases,1219327,0,1219327
2008,PA,Petroleum,1875848,0,1875848
2008,PA,Pumped Storage,0,-707524,-707524
2008,PA,Solar Thermal and Photovoltaic,0,350,350
2008,PA,Total,0,444701850,444701850
2008,PA,Wind,0,1458850,1458850
2008,PA,Wood and Wood Derived Fuels,1315952,0,1315952
2008,RI,Hydroelectric Conventional,0,9954,9954
2008,RI,Natural Gas,14395096,0,14395096
2008,RI,Other Biomass,316814,0,316814
2008,RI,Petroleum,52668,0,52668
2008,RI,Total,0,14774532,14774532
2008,SC,Coal,83079390,0,83079390
2008,SC,Hydroelectric Conventional,0,2246230,2246230
2008,SC,Natural Gas,11457977,0,11457977
2008,SC,Nuclear,0,103525900,103525900
2008,SC,Other,187059,0,187059
2008,SC,Other Biomass,239518,0,239518
2008,SC,Other Gases,0,0,0
2008,SC,Petroleum,360934,0,360934
2008,SC,Pumped Storage,0,-2533128,-2533128
2008,SC,Total,0,201956010,201956010
2008,SC,Wood and Wood Derived Fuels,3392134,0,3392134
2008,SD,Coal,7320964,0,7320964
2008,SD,Hydroelectric Conventional,0,5986214,5986214
2008,SD,Natural Gas,457138,0,457138
2008,SD,Other,61076,0,61076
2008,SD,Other Biomass,3330,0,3330
2008,SD,Petroleum,46350,0,46350
2008,SD,Total,0,14165344,14165344
2008,SD,Wind,0,290272,290272
2008,TN,Coal,114116258,0,114116258
2008,TN,Hydroelectric Conventional,0,11292146,11292146
2008,TN,Natural Gas,934460,0,934460
2008,TN,Nuclear,0,54059234,54059234
2008,TN,Other,15834,0,15834
2008,TN,Other Biomass,71800,0,71800
2008,TN,Other Gases,24060,0,24060
2008,TN,Petroleum,431368,0,431368
2008,TN,Pumped Storage,0,-1477358,-1477358
2008,TN,Total,0,181326624,181326624
2008,TN,Wind,0,100234,100234
2008,TN,Wood and Wood Derived Fuels,1758586,0,1758586
2008,TX,Coal,294263681,0,294263681
2008,TX,Hydroelectric Conventional,0,2078934,2078934
2008,TX,Natural Gas,386494156,0,386494156
2008,TX,Nuclear,0,81454740,81454740
2008,TX,Other,1137810,0,1137810
2008,TX,Other Biomass,876946,0,876946
2008,TX,Other Gases,6801012,0,6801012
2008,TX,Petroleum,2067039,0,2067039
2008,TX,Total,0,809575563,809575563
2008,TX,Wind,0,32450044,32450044
2008,TX,Wood and Wood Derived Fuels,1951198,0,1951198
2008,UT,Coal,76040733,0,76040733
2008,UT,Geothermal,508554,0,508554
2008,UT,Hydroelectric Conventional,0,1336168,1336168
2008,UT,Natural Gas,14732614,0,14732614
2008,UT,Other,285486,0,285486
2008,UT,Other Biomass,47370,0,47370
2008,UT,Other Gases,71576,0,71576
2008,UT,Petroleum,87224,0,87224
2008,UT,Total,0,93157525,93157525
2008,UT,Wind,0,47800,47800
2008,VA,Coal,63552712,0,63552712
2008,VA,Hydroelectric Conventional,0,2021986,2021986
2008,VA,Natural Gas,18630166,0,18630166
2008,VA,Nuclear,0,55861528,55861528
2008,VA,Other,868409,0,868409
2008,VA,Other Biomass,1564344,0,1564344
2008,VA,Petroleum,2300719,0,2300719
2008,VA,Pumped Storage,0,-3275376,-3275376
2008,VA,Total,0,145357063,145357063
2008,VA,Wood and Wood Derived Fuels,3832576,0,3832576
2008,VT,Hydroelectric Conventional,0,2985808,2985808
2008,VT,Natural Gas,5310,0,5310
2008,VT,Nuclear,0,9790106,9790106
2008,VT,Other Biomass,0,0,0
2008,VT,Petroleum,8532,0,8532
2008,VT,Total,0,13640432,13640432
2008,VT,Wind,0,20470,20470
2008,VT,Wood and Wood Derived Fuels,830206,0,830206
2008,WA,Coal,17523288,0,17523288
2008,WA,Hydroelectric Conventional,0,155273516,155273516
2008,WA,Natural Gas,19618708,0,19618708
2008,WA,Nuclear,0,18539278,18539278
2008,WA,Other,112754,0,112754
2008,WA,Other Biomass,335762,0,335762
2008,WA,Other Gases,544678,0,544678
2008,WA,Petroleum,70378,0,70378
2008,WA,Pumped Storage,0,97426,97426
2008,WA,Solar Thermal and Photovoltaic,0,0,0
2008,WA,Total,0,221656901,221656901
2008,WA,Wind,0,7314968,7314968
2008,WA,Wood and Wood Derived Fuels,2226146,0,2226146
2008,WI,Coal,83411720,0,83411720
2008,WI,Hydroelectric Conventional,0,3232284,3232284
2008,WI,Natural Gas,10487178,0,10487178
2008,WI,Nuclear,0,24309020,24309020
2008,WI,Other,148717,0,148717
2008,WI,Other Biomass,983509,0,983509
2008,WI,Petroleum,1862319,0,1862319
2008,WI,Total,0,126959110,126959110
2008,WI,Wind,0,974282,974282
2008,WI,Wood and Wood Derived Fuels,1550080,0,1550080
2008,WV,Coal,178226960,0,178226960
2008,WV,Hydroelectric Conventional,0,2496074,2496074
2008,WV,Natural Gas,360820,0,360820
2008,WV,Other,4398,0,4398
2008,WV,Other Biomass,0,0,0
2008,WV,Other Gases,100502,0,100502
2008,WV,Petroleum,274398,0,274398
2008,WV,Total,0,182246194,182246194
2008,WV,Wind,0,783820,783820
2008,WV,Wood and Wood Derived Fuels,-780,0,-780
2008,WY,Coal,87615806,0,87615806
2008,WY,Hydroelectric Conventional,0,1670550,1670550
2008,WY,Natural Gas,989358,0,989358
2008,WY,Other,134754,0,134754
2008,WY,Other Gases,577290,0,577290
2008,WY,Petroleum,88054,0,88054
2008,WY,Total,0,93000896,93000896
2008,WY,Wind,0,1925084,1925084
2009,AK,Coal,1261184,0,1261184
2009,AK,Hydroelectric Conventional,0,2647488,2647488
2009,AK,Natural Gas,7154806,0,7154806
2009,AK,Other,0,0,0
2009,AK,Other Biomass,13022,0,13022
2009,AK,Petroleum,2313764,0,2313764
2009,AK,Total,0,13404318,13404318
2009,AK,Wind,0,14054,14054
2009,AL,Coal,111217448,0,111217448
2009,AL,Hydroelectric Conventional,0,25070746,25070746
2009,AL,Natural Gas,63234166,0,63234166
2009,AL,Nuclear,0,79432408,79432408
2009,AL,Other,748628,0,748628
2009,AL,Other Biomass,28964,0,28964
2009,AL,Other Gases,269456,0,269456
2009,AL,Petroleum,438547,0,438547
2009,AL,Total,0,286511112,286511112
2009,AL,Wood and Wood Derived Fuels,6070750,0,6070750
2009,AR,Coal,50150500,0,50150500
2009,AR,Hydroelectric Conventional,0,8385412,8385412
2009,AR,Natural Gas,22442826,0,22442826
2009,AR,Nuclear,0,30339932,30339932
2009,AR,Other,48038,0,48038
2009,AR,Other Biomass,114100,0,114100
2009,AR,Petroleum,176940,0,176940
2009,AR,Pumped Storage,0,200730,200730
2009,AR,Total,0,114915478,114915478
2009,AR,Wood and Wood Derived Fuels,3057002,0,3057002
2009,AZ,Coal,79413634,0,79413634
2009,AZ,Hydroelectric Conventional,0,12854690,12854690
2009,AZ,Natural Gas,69478339,0,69478339
2009,AZ,Nuclear,0,61323702,61323702
2009,AZ,Other,3134,0,3134
2009,AZ,Other Biomass,43980,0,43980
2009,AZ,Petroleum,125398,0,125398
2009,AZ,Pumped Storage,0,338960,338960
2009,AZ,Solar Thermal and Photovoltaic,0,28290,28290
2009,AZ,Total,0,223942500,223942500
2009,AZ,Wind,0,59090,59090
2009,AZ,Wood and Wood Derived Fuels,273282,0,273282
2009,CA,Coal,4099894,0,4099894
2009,CA,Geothermal,25705566,0,25705566
2009,CA,Hydroelectric Conventional,0,55776073,55776073
2009,CA,Natural Gas,226926910,0,226926910
2009,CA,Nuclear,0,63527608,63527608
2009,CA,Other,1505374,0,1505374
2009,CA,Other Biomass,4935320,0,4935320
2009,CA,Other Gases,3245688,0,3245688
2009,CA,Petroleum,3085697,0,3085697
2009,CA,Pumped Storage,0,305698,305698
2009,CA,Solar Thermal and Photovoltaic,0,1294780,1294780
2009,CA,Total,0,409552265,409552265
2009,CA,Wind,0,11679626,11679626
2009,CA,Wood and Wood Derived Fuels,7464031,0,7464031
2009,CO,Coal,63272046,0,63272046
2009,CO,Hydroelectric Conventional,0,3771448,3771448
2009,CO,Natural Gas,27680050,0,27680050
2009,CO,Other,106822,0,106822
2009,CO,Other Biomass,112328,0,112328
2009,CO,Other Gases,0,0,0
2009,CO,Petroleum,26907,0,26907
2009,CO,Pumped Storage,0,-217316,-217316
2009,CO,Solar Thermal and Photovoltaic,0,51170,51170
2009,CO,Total,0,101131904,101131904
2009,CO,Wind,0,6327672,6327672
2009,CO,Wood and Wood Derived Fuels,776,0,776
2009,CT,Coal,4906995,0,4906995
2009,CT,Hydroelectric Conventional,0,1019092,1019092
2009,CT,Natural Gas,19618702,0,19618702
2009,CT,Nuclear,0,33314764,33314764
2009,CT,Other,1426906,0,1426906
2009,CT,Other Biomass,1516216,0,1516216
2009,CT,Other Gases,0,0,0
2009,CT,Petroleum,597756,0,597756
2009,CT,Pumped Storage,0,10770,10770
2009,CT,Total,0,62412444,62412444
2009,CT,Wood and Wood Derived Fuels,1244,0,1244
2009,DC,Petroleum,70998,0,70998
2009,DC,Total,0,70998,70998
2009,DE,Coal,5696342,0,5696342
2009,DE,Natural Gas,2752802,0,2752802
2009,DE,Other,11754,0,11754
2009,DE,Other Biomass,251222,0,251222
2009,DE,Other Gases,454274,0,454274
2009,DE,Petroleum,516731,0,516731
2009,DE,Total,0,9683126,9683126
2009,FL,Coal,108006144,0,108006144
2009,FL,Hydroelectric Conventional,0,416404,416404
2009,FL,Natural Gas,236644616,0,236644616
2009,FL,Nuclear,0,58235754,58235754
2009,FL,Other,5465402,0,5465402
2009,FL,Other Biomass,4753474,0,4753474
2009,FL,Other Gases,13600,0,13600
2009,FL,Petroleum,18442033,0,18442033
2009,FL,Solar Thermal and Photovoltaic,0,18940,18940
2009,FL,Total,0,435904617,435904617
2009,FL,Wood and Wood Derived Fuels,3908249,0,3908249
2009,GA,Coal,138956392,0,138956392
2009,GA,Hydroelectric Conventional,0,6519366,6519366
2009,GA,Natural Gas,41011499,0,41011499
2009,GA,Nuclear,0,63365158,63365158
2009,GA,Other,50674,0,50674
2009,GA,Other Biomass,159200,0,159200
2009,GA,Petroleum,1299347,0,1299347
2009,GA,Pumped Storage,0,543976,543976
2009,GA,Total,0,257396752,257396752
2009,GA,Wood and Wood Derived Fuels,5491138,0,5491138
2009,HI,Coal,3000332,0,3000332
2009,HI,Geothermal,335182,0,335182
2009,HI,Hydroelectric Conventional,0,225298,225298
2009,HI,Other,762864,0,762864
2009,HI,Other Biomass,568854,0,568854
2009,HI,Other Gases,44690,0,44690
2009,HI,Petroleum,16578214,0,16578214
2009,HI,Solar Thermal and Photovoltaic,0,2780,2780
2009,HI,Total,0,22021066,22021066
2009,HI,Wind,0,502854,502854
2009,IA,Coal,74702872,0,74702872
2009,IA,Hydroelectric Conventional,0,1942330,1942330
2009,IA,Natural Gas,2368434,0,2368434
2009,IA,Nuclear,0,9357862,9357862
2009,IA,Other,926,0,926
2009,IA,Other Biomass,335775,0,335775
2009,IA,Petroleum,170502,0,170502
2009,IA,Total,0,103720127,103720127
2009,IA,Wind,0,14841040,14841040
2009,IA,Wood and Wood Derived Fuels,388,0,388
2009,ID,Coal,165130,0,165130
2009,ID,Geothermal,151900,0,151900
2009,ID,Hydroelectric Conventional,0,20868528,20868528
2009,ID,Natural Gas,3287190,0,3287190
2009,ID,Other,144742,0,144742
2009,ID,Other Biomass,0,0,0
2009,ID,Petroleum,82,0,82
2009,ID,Total,0,26200304,26200304
2009,ID,Wind,0,626836,626836
2009,ID,Wood and Wood Derived Fuels,955896,0,955896
2009,IL,Coal,179933720,0,179933720
2009,IL,Hydroelectric Conventional,0,272760,272760
2009,IL,Natural Gas,8989439,0,8989439
2009,IL,Nuclear,0,190947840,190947840
2009,IL,Other,123640,0,123640
2009,IL,Other Biomass,1419486,0,1419486
2009,IL,Other Gases,176748,0,176748
2009,IL,Petroleum,225062,0,225062
2009,IL,Solar Thermal and Photovoltaic,0,32,32
2009,IL,Total,0,387728715,387728715
2009,IL,Wind,0,5639064,5639064
2009,IL,Wood and Wood Derived Fuels,922,0,922
2009,IN,Coal,216623396,0,216623396
2009,IN,Hydroelectric Conventional,0,1006940,1006940
2009,IN,Natural Gas,7659316,0,7659316
2009,IN,Other,685591,0,685591
2009,IN,Other Biomass,605288,0,605288
2009,IN,Other Gases,3640130,0,3640130
2009,IN,Petroleum,313514,0,313514
2009,IN,Total,0,233340560,233340560
2009,IN,Wind,0,2806384,2806384
2009,KS,Coal,64486086,0,64486086
2009,KS,Hydroelectric Conventional,0,25596,25596
2009,KS,Natural Gas,5337782,0,5337782
2009,KS,Nuclear,0,17537096,17537096
2009,KS,Other Biomass,0,0,0
2009,KS,Petroleum,241522,0,241522
2009,KS,Total,0,93354616,93354616
2009,KS,Wind,0,5726534,5726534
2009,KY,Coal,168075192,0,168075192
2009,KY,Hydroelectric Conventional,0,6635282,6635282
2009,KY,Natural Gas,1756860,0,1756860
2009,KY,Other,25258,0,25258
2009,KY,Other Biomass,201748,0,201748
2009,KY,Other Gases,8628,0,8628
2009,KY,Petroleum,4032564,0,4032564
2009,KY,Total,0,181260854,181260854
2009,KY,Wood and Wood Derived Fuels,525320,0,525320
2009,LA,Coal,46134273,0,46134273
2009,LA,Hydroelectric Conventional,0,2472702,2472702
2009,LA,Natural Gas,88006529,0,88006529
2009,LA,Nuclear,0,33564154,33564154
2009,LA,Other,912372,0,912372
2009,LA,Other Biomass,134372,0,134372
2009,LA,Other Gases,2453987,0,2453987
2009,LA,Petroleum,3715418,0,3715418
2009,LA,Total,0,181987352,181987352
2009,LA,Wood and Wood Derived Fuels,4593546,0,4593546
2009,MA,Coal,18056220,0,18056220
2009,MA,Hydroelectric Conventional,0,2402152,2402152
2009,MA,Natural Gas,41975672,0,41975672
2009,MA,Nuclear,0,10792042,10792042
2009,MA,Other,1521818,0,1521818
2009,MA,Other Biomass,2215750,0,2215750
2009,MA,Petroleum,1794156,0,1794156
2009,MA,Pumped Storage,0,-1067272,-1067272
2009,MA,Solar Thermal and Photovoltaic,0,86,86
2009,MA,Total,0,77933303,77933303
2009,MA,Wind,0,11912,11912
2009,MA,Wood and Wood Derived Fuels,230768,0,230768
2009,MD,Coal,48324691,0,48324691
2009,MD,Hydroelectric Conventional,0,3777538,3777538
2009,MD,Natural Gas,3535690,0,3535690
2009,MD,Nuclear,0,29100238,29100238
2009,MD,Other,511782,0,511782
2009,MD,Other Biomass,751445,0,751445
2009,MD,Other Gases,538364,0,538364
2009,MD,Petroleum,659801,0,659801
2009,MD,Total,0,87549663,87549663
2009,MD,Wood and Wood Derived Fuels,350114,0,350114
2009,ME,Coal,144292,0,144292
2009,ME,Hydroelectric Conventional,0,8423358,8423358
2009,ME,Natural Gas,14710788,0,14710788
2009,ME,Other,677905,0,677905
2009,ME,Other Biomass,545743,0,545743
2009,ME,Petroleum,866867,0,866867
2009,ME,Total,0,32699698,32699698
2009,ME,Wind,0,597246,597246
2009,ME,Wood and Wood Derived Fuels,6733500,0,6733500
2009,MI,Coal,133695366,0,133695366
2009,MI,Hydroelectric Conventional,0,2743852,2743852
2009,MI,Natural Gas,16839101,0,16839101
2009,MI,Nuclear,0,43702018,43702018
2009,MI,Other,688716,0,688716
2009,MI,Other Biomass,1668024,0,1668024
2009,MI,Other Gases,405020,0,405020
2009,MI,Petroleum,798498,0,798498
2009,MI,Pumped Storage,0,-1713728,-1713728
2009,MI,Total,0,202405210,202405210
2009,MI,Wind,0,600344,600344
2009,MI,Wood and Wood Derived Fuels,2978002,0,2978002
2009,MN,Coal,58654452,0,58654452
2009,MN,Hydroelectric Conventional,0,1618176,1618176
2009,MN,Natural Gas,5692966,0,5692966
2009,MN,Nuclear,0,24786850,24786850
2009,MN,Other,579199,0,579199
2009,MN,Other Biomass,1774607,0,1774607
2009,MN,Other Gases,48224,0,48224
2009,MN,Petroleum,130518,0,130518
2009,MN,Total,0,104983698,104983698
2009,MN,Wind,0,10106044,10106044
2009,MN,Wood and Wood Derived Fuels,1592663,0,1592663
2009,MO,Coal,143222480,0,143222480
2009,MO,Hydroelectric Conventional,0,3633386,3633386
2009,MO,Natural Gas,6832463,0,6832463
2009,MO,Nuclear,0,20494232,20494232
2009,MO,Other,54846,0,54846
2009,MO,Other Biomass,146676,0,146676
2009,MO,Other Gases,13064,0,13064
2009,MO,Petroleum,175039,0,175039
2009,MO,Pumped Storage,0,1133426,1133426
2009,MO,Total,0,176708544,176708544
2009,MO,Wind,0,998754,998754
2009,MO,Wood and Wood Derived Fuels,4180,0,4180
2009,MS,Coal,25915324,0,25915324
2009,MS,Natural Gas,46534598,0,46534598
2009,MS,Nuclear,0,21997030,21997030
2009,MS,Other,24786,0,24786
2009,MS,Other Biomass,13920,0,13920
2009,MS,Other Gases,49470,0,49470
2009,MS,Petroleum,33202,0,33202
2009,MS,Total,0,97402968,97402968
2009,MS,Wood and Wood Derived Fuels,2834638,0,2834638
2009,MT,Coal,31222558,0,31222558
2009,MT,Hydroelectric Conventional,0,19011880,19011880
2009,MT,Natural Gas,155523,0,155523
2009,MT,Other,220616,0,220616
2009,MT,Other Gases,2894,0,2894
2009,MT,Petroleum,980866,0,980866
2009,MT,Total,0,53425471,53425471
2009,MT,Wind,0,1641848,1641848
2009,MT,Wood and Wood Derived Fuels,189284,0,189284
2009,NC,Coal,130165565,0,130165565
2009,NC,Hydroelectric Conventional,0,10342514,10342514
2009,NC,Natural Gas,9703769,0,9703769
2009,NC,Nuclear,0,81695422,81695422
2009,NC,Other,440856,0,440856
2009,NC,Other Biomass,262982,0,262982
2009,NC,Other Gases,0,0,0
2009,NC,Petroleum,593717,0,593717
2009,NC,Pumped Storage,0,86154,86154
2009,NC,Solar Thermal and Photovoltaic,0,9126,9126
2009,NC,Total,0,236814806,236814806
2009,NC,Wood and Wood Derived Fuels,3514699,0,3514699
2009,ND,Coal,59213931,0,59213931
2009,ND,Hydroelectric Conventional,0,2950502,2950502
2009,ND,Natural Gas,33212,0,33212
2009,ND,Other,0,0,0
2009,ND,Other Biomass,23144,0,23144
2009,ND,Other Gases,87052,0,87052
2009,ND,Petroleum,90032,0,90032
2009,ND,Total,0,68392933,68392933
2009,ND,Wind,0,5995060,5995060
2009,NE,Coal,46699560,0,46699560
2009,NE,Hydroelectric Conventional,0,867380,867380
2009,NE,Natural Gas,623163,0,623163
2009,NE,Nuclear,0,18870284,18870284
2009,NE,Other Biomass,132390,0,132390
2009,NE,Petroleum,45738,0,45738
2009,NE,Total,0,68003784,68003784
2009,NE,Wind,0,765268,765268
2009,NH,Coal,5771336,0,5771336
2009,NH,Hydroelectric Conventional,0,3360984,3360984
2009,NH,Natural Gas,10684714,0,10684714
2009,NH,Nuclear,0,17633346,17633346
2009,NH,Other,115830,0,115830
2009,NH,Other Biomass,302556,0,302556
2009,NH,Petroleum,366162,0,366162
2009,NH,Total,0,40328244,40328244
2009,NH,Wind,0,124954,124954
2009,NH,Wood and Wood Derived Fuels,1968361,0,1968361
2009,NJ,Coal,10199736,0,10199736
2009,NJ,Hydroelectric Conventional,0,64162,64162
2009,NJ,Natural Gas,41249982,0,41249982
2009,NJ,Nuclear,0,68655908,68655908
2009,NJ,Other,1040615,0,1040615
2009,NJ,Other Biomass,1856413,0,1856413
2009,NJ,Other Gases,339460,0,339460
2009,NJ,Petroleum,556382,0,556382
2009,NJ,Pumped Storage,0,-403428,-403428
2009,NJ,Solar Thermal and Photovoltaic,0,21414,21414
2009,NJ,Total,0,123622478,123622478
2009,NJ,Wind,0,41836,41836
2009,NM,Coal,58234616,0,58234616
2009,NM,Hydroelectric Conventional,0,541926,541926
2009,NM,Natural Gas,17322146,0,17322146
2009,NM,Other Biomass,67328,0,67328
2009,NM,Petroleum,89226,0,89226
2009,NM,Total,0,79348678,79348678
2009,NM,Wind,0,3093436,3093436
2009,NV,Coal,15079873,0,15079873
2009,NV,Geothermal,3266426,0,3266426
2009,NV,Hydroelectric Conventional,0,4921190,4921190
2009,NV,Natural Gas,51755242,0,51755242
2009,NV,Other Gases,4770,0,4770
2009,NV,Petroleum,32367,0,32367
2009,NV,Solar Thermal and Photovoltaic,0,348618,348618
2009,NV,Total,0,75410266,75410266
2009,NV,Wood and Wood Derived Fuels,1780,0,1780
2009,NY,Coal,25517745,0,25517745
2009,NY,Hydroelectric Conventional,0,55230213,55230213
2009,NY,Natural Gas,83559194,0,83559194
2009,NY,Nuclear,0,86969228,86969228
2009,NY,Other,1754866,0,1754866
2009,NY,Other Biomass,3329632,0,3329632
2009,NY,Petroleum,5296611,0,5296611
2009,NY,Pumped Storage,0,-960774,-960774
2009,NY,Total,0,266301099,266301099
2009,NY,Wind,0,4532678,4532678
2009,NY,Wood and Wood Derived Fuels,1071706,0,1071706
2009,OH,Coal,227423994,0,227423994
2009,OH,Hydroelectric Conventional,0,1055492,1055492
2009,OH,Natural Gas,9300912,0,9300912
2009,OH,Nuclear,0,30412168,30412168
2009,OH,Other,22624,0,22624
2009,OH,Other Biomass,419222,0,419222
2009,OH,Other Gases,74954,0,74954
2009,OH,Petroleum,2623486,0,2623486
2009,OH,Total,0,272180450,272180450
2009,OH,Wind,0,28228,28228
2009,OH,Wood and Wood Derived Fuels,819371,0,819371
2009,OK,Coal,68118214,0,68118214
2009,OK,Hydroelectric Conventional,0,7105146,7105146
2009,OK,Natural Gas,69262598,0,69262598
2009,OK,Other,3850,0,3850
2009,OK,Other Biomass,326020,0,326020
2009,OK,Other Gases,0,0,0
2009,OK,Petroleum,18926,0,18926
2009,OK,Pumped Storage,0,-233662,-233662
2009,OK,Total,0,150133618,150133618
2009,OK,Wind,0,5396398,5396398
2009,OK,Wood and Wood Derived Fuels,136128,0,136128
2009,OR,Coal,6393804,0,6393804
2009,OR,Hydroelectric Conventional,0,66067026,66067026
2009,OR,Natural Gas,32266902,0,32266902
2009,OR,Other,93217,0,93217
2009,OR,Other Biomass,256664,0,256664
2009,OR,Petroleum,15910,0,15910
2009,OR,Total,0,113381712,113381712
2009,OR,Wind,0,6939428,6939428
2009,OR,Wood and Wood Derived Fuels,1348762,0,1348762
2009,PA,Coal,210949068,0,210949068
2009,PA,Hydroelectric Conventional,0,5365732,5365732
2009,PA,Natural Gas,58429910,0,58429910
2009,PA,Nuclear,0,154655372,154655372
2009,PA,Other,1634188,0,1634188
2009,PA,Other Biomass,3158672,0,3158672
2009,PA,Other Gases,885008,0,885008
2009,PA,Petroleum,1830174,0,1830174
2009,PA,Pumped Storage,0,-1461022,-1461022
2009,PA,Solar Thermal and Photovoltaic,0,7124,7124
2009,PA,Total,0,438992287,438992287
2009,PA,Wind,0,2149576,2149576
2009,PA,Wood and Wood Derived Fuels,1388484,0,1388484
2009,RI,Hydroelectric Conventional,0,9472,9472
2009,RI,Natural Gas,15060715,0,15060715
2009,RI,Other Biomass,289200,0,289200
2009,RI,Petroleum,34262,0,34262
2009,RI,Total,0,15393648,15393648
2009,SC,Coal,68955025,0,68955025
2009,SC,Hydroelectric Conventional,0,4664010,4664010
2009,SC,Natural Gas,19560386,0,19560386
2009,SC,Nuclear,0,104299468,104299468
2009,SC,Other,182059,0,182059
2009,SC,Other Biomass,274508,0,274508
2009,SC,Other Gases,0,0,0
2009,SC,Petroleum,1046968,0,1046968
2009,SC,Pumped Storage,0,-1952886,-1952886
2009,SC,Total,0,200250972,200250972
2009,SC,Wood and Wood Derived Fuels,3221435,0,3221435
2009,SD,Coal,6434706,0,6434706
2009,SD,Hydroelectric Conventional,0,8864902,8864902
2009,SD,Natural Gas,160668,0,160668
2009,SD,Other,62636,0,62636
2009,SD,Other Biomass,11550,0,11550
2009,SD,Petroleum,16640,0,16640
2009,SD,Total,0,16393062,16393062
2009,SD,Wind,0,841962,841962
2009,TN,Coal,83266480,0,83266480
2009,TN,Hydroelectric Conventional,0,20423924,20423924
2009,TN,Natural Gas,818642,0,818642
2009,TN,Nuclear,0,53924002,53924002
2009,TN,Other,1576,0,1576
2009,TN,Other Biomass,72600,0,72600
2009,TN,Other Gases,24020,0,24020
2009,TN,Petroleum,373860,0,373860
2009,TN,Pumped Storage,0,-1299664,-1299664
2009,TN,Total,0,159433778,159433778
2009,TN,Wind,0,103494,103494
2009,TN,Wood and Wood Derived Fuels,1724842,0,1724842
2009,TX,Coal,278213194,0,278213194
2009,TX,Hydroelectric Conventional,0,2057314,2057314
2009,TX,Natural Gas,378132967,0,378132967
2009,TX,Nuclear,0,82995234,82995234
2009,TX,Other,620338,0,620338
2009,TX,Other Biomass,858150,0,858150
2009,TX,Other Gases,7298610,0,7298610
2009,TX,Petroleum,2809212,0,2809212
2009,TX,Total,0,794335819,794335819
2009,TX,Wind,0,40052206,40052206
2009,TX,Wood and Wood Derived Fuels,1298596,0,1298596
2009,UT,Coal,71052252,0,71052252
2009,UT,Geothermal,558242,0,558242
2009,UT,Hydroelectric Conventional,0,1670514,1670514
2009,UT,Natural Gas,12888084,0,12888084
2009,UT,Other,373988,0,373988
2009,UT,Other Biomass,95756,0,95756
2009,UT,Other Gases,55866,0,55866
2009,UT,Petroleum,72114,0,72114
2009,UT,Total,0,87085892,87085892
2009,UT,Wind,0,319074,319074
2009,VA,Coal,51198575,0,51198575
2009,VA,Hydroelectric Conventional,0,2957260,2957260
2009,VA,Natural Gas,24402768,0,24402768
2009,VA,Nuclear,0,56424504,56424504
2009,VA,Other,840084,0,840084
2009,VA,Other Biomass,1418406,0,1418406
2009,VA,Petroleum,2175320,0,2175320
2009,VA,Pumped Storage,0,-2669418,-2669418
2009,VA,Total,0,140164131,140164131
2009,VA,Wood and Wood Derived Fuels,3416632,0,3416632
2009,VT,Hydroelectric Conventional,0,2971650,2971650
2009,VT,Natural Gas,8862,0,8862
2009,VT,Nuclear,0,10721216,10721216
2009,VT,Other Biomass,48380,0,48380
2009,VT,Petroleum,4878,0,4878
2009,VT,Total,0,14564696,14564696
2009,VT,Wind,0,23178,23178
2009,VT,Wood and Wood Derived Fuels,786532,0,786532
2009,WA,Coal,14955546,0,14955546
2009,WA,Hydroelectric Conventional,0,145865408,145865408
2009,WA,Natural Gas,23942283,0,23942283
2009,WA,Nuclear,0,13268028,13268028
2009,WA,Other,117912,0,117912
2009,WA,Other Biomass,334045,0,334045
2009,WA,Other Gases,489776,0,489776
2009,WA,Petroleum,107208,0,107208
2009,WA,Pumped Storage,0,104766,104766
2009,WA,Solar Thermal and Photovoltaic,0,0,0
2009,WA,Total,0,208940266,208940266
2009,WA,Wind,0,7144972,7144972
2009,WA,Wood and Wood Derived Fuels,2610324,0,2610324
2009,WI,Coal,74559990,0,74559990
2009,WI,Hydroelectric Conventional,0,2787977,2787977
2009,WI,Natural Gas,10968280,0,10968280
2009,WI,Nuclear,0,25366302,25366302
2009,WI,Other,130080,0,130080
2009,WI,Other Biomass,1038348,0,1038348
2009,WI,Petroleum,1424901,0,1424901
2009,WI,Total,0,119918121,119918121
2009,WI,Wind,0,2103930,2103930
2009,WI,Wood and Wood Derived Fuels,1538312,0,1538312
2009,WV,Coal,136159799,0,136159799
2009,WV,Hydroelectric Conventional,0,3291854,3291854
2009,WV,Natural Gas,218870,0,218870
2009,WV,Other,930,0,930
2009,WV,Other Biomass,-298,0,-298
2009,WV,Other Gases,71736,0,71736
2009,WV,Petroleum,338636,0,338636
2009,WV,Total,0,141565028,141565028
2009,WV,Wind,0,1484878,1484878
2009,WV,Wood and Wood Derived Fuels,-1378,0,-1378
2009,WY,Coal,83908533,0,83908533
2009,WY,Hydroelectric Conventional,0,1933144,1933144
2009,WY,Natural Gas,976028,0,976028
2009,WY,Other,119226,0,119226
2009,WY,Other Gases,568722,0,568722
2009,WY,Petroleum,100362,0,100362
2009,WY,Total,0,92058425,92058425
2009,WY,Wind,0,4452410,4452410
2010,AK,Coal,1240887,0,1240887
2010,AK,Hydroelectric Conventional,0,2866282,2866282
2010,AK,Natural Gas,7500048,0,7500048
2010,AK,Other,0,0,0
2010,AK,Other Biomass,12608,0,12608
2010,AK,Petroleum,1874112,0,1874112
2010,AK,Total,0,13519152,13519152
2010,AK,Wind,0,25214,25214
2010,AL,Coal,126100821,0,126100821
2010,AL,Hydroelectric Conventional,0,17408508,17408508
2010,AL,Natural Gas,78470035,0,78470035
2010,AL,Nuclear,0,75881642,75881642
2010,AL,Other,732888,0,732888
2010,AL,Other Biomass,23065,0,23065
2010,AL,Other Gases,553450,0,553450
2010,AL,Petroleum,399707,0,399707
2010,AL,Total,0,304301024,304301024
2010,AL,Wood and Wood Derived Fuels,4730907,0,4730907
2010,AR,Coal,56304890,0,56304890
2010,AR,Hydroelectric Conventional,0,7317924,7317924
2010,AR,Natural Gas,24938154,0,24938154
2010,AR,Nuclear,0,30045356,30045356
2010,AR,Other,56842,0,56842
2010,AR,Other Biomass,113918,0,113918
2010,AR,Petroleum,90358,0,90358
2010,AR,Pumped Storage,0,-1042,-1042
2010,AR,Total,0,122000370,122000370
2010,AR,Wood and Wood Derived Fuels,3133968,0,3133968
2010,AZ,Coal,87287614,0,87287614
2010,AZ,Hydroelectric Conventional,0,13244320,13244320
2010,AZ,Natural Gas,59351884,0,59351884
2010,AZ,Nuclear,0,62399870,62399870
2010,AZ,Other,29484,0,29484
2010,AZ,Other Biomass,56822,0,56822
2010,AZ,Petroleum,132869,0,132869
2010,AZ,Pumped Storage,0,418060,418060
2010,AZ,Solar Thermal and Photovoltaic,0,31508,31508
2010,AZ,Total,0,223501915,223501915
2010,AZ,Wind,0,269832,269832
2010,AZ,Wood and Wood Derived Fuels,279652,0,279652
2010,CA,Coal,4200442,0,4200442
2010,CA,Geothermal,25200196,0,25200196
2010,CA,Hydroelectric Conventional,0,66861740,66861740
2010,CA,Natural Gas,215044626,0,215044626
2010,CA,Nuclear,0,64401514,64401514
2010,CA,Other,1678096,0,1678096
2010,CA,Other Biomass,4901565,0,4901565
2010,CA,Other Gases,3389281,0,3389281
2010,CA,Petroleum,2118578,0,2118578
2010,CA,Pumped Storage,0,-342530,-342530
2010,CA,Solar Thermal and Photovoltaic,0,1538662,1538662
2010,CA,Total,0,408251191,408251191
2010,CA,Wind,0,12157264,12157264
2010,CA,Wood and Wood Derived Fuels,7101755,0,7101755
2010,CO,Coal,69118580,0,69118580
2010,CO,Hydroelectric Conventional,0,3156528,3156528
2010,CO,Natural Gas,22124549,0,22124549
2010,CO,Other,139482,0,139482
2010,CO,Other Biomass,115958,0,115958
2010,CO,Other Gases,0,0,0
2010,CO,Petroleum,34965,0,34965
2010,CO,Pumped Storage,0,-241584,-241584
2010,CO,Solar Thermal and Photovoltaic,0,84996,84996
2010,CO,Total,0,101441583,101441583
2010,CO,Wind,0,6903702,6903702
2010,CO,Wood and Wood Derived Fuels,4410,0,4410
2010,CT,Coal,5208798,0,5208798
2010,CT,Hydroelectric Conventional,0,781334,781334
2010,CT,Natural Gas,23431345,0,23431345
2010,CT,Nuclear,0,33500608,33500608
2010,CT,Other,1433122,0,1433122
2010,CT,Other Biomass,1478492,0,1478492
2010,CT,Other Gases,27872,0,27872
2010,CT,Petroleum,817863,0,817863
2010,CT,Pumped Storage,0,18984,18984
2010,CT,Total,0,66699247,66699247
2010,CT,Wood and Wood Derived Fuels,828,0,828
2010,DC,Petroleum,399716,0,399716
2010,DC,Total,0,399716,399716
2010,DE,Coal,5136740,0,5136740
2010,DE,Natural Gas,5729966,0,5729966
2010,DE,Other,0,0,0
2010,DE,Other Biomass,271282,0,271282
2010,DE,Other Gases,0,0,0
2010,DE,Petroleum,112189,0,112189
2010,DE,Total,0,11255290,11255290
2010,DE,Wind,0,5112,5112
2010,FL,Coal,119794866,0,119794866
2010,FL,Hydroelectric Conventional,0,354948,354948
2010,FL,Natural Gas,257268504,0,257268504
2010,FL,Nuclear,0,47871844,47871844
2010,FL,Other,5667118,0,5667118
2010,FL,Other Biomass,4774832,0,4774832
2010,FL,Other Gases,16150,0,16150
2010,FL,Petroleum,18244994,0,18244994
2010,FL,Solar Thermal and Photovoltaic,0,160880,160880
2010,FL,Total,0,458191870,458191870
2010,FL,Wood and Wood Derived Fuels,4037735,0,4037735
2010,GA,Coal,146596084,0,146596084
2010,GA,Hydroelectric Conventional,0,6643404,6643404
2010,GA,Natural Gas,47768915,0,47768915
2010,GA,Nuclear,0,67024066,67024066
2010,GA,Other,35072,0,35072
2010,GA,Other Biomass,254002,0,254002
2010,GA,Petroleum,1281126,0,1281126
2010,GA,Pumped Storage,0,-555908,-555908
2010,GA,Total,0,275153882,275153882
2010,GA,Wood and Wood Derived Fuels,6107123,0,6107123
2010,HI,Coal,3091027,0,3091027
2010,HI,Geothermal,401190,0,401190
2010,HI,Hydroelectric Conventional,0,140846,140846
2010,HI,Other,727760,0,727760
2010,HI,Other Biomass,566948,0,566948
2010,HI,Other Gases,43830,0,43830
2010,HI,Petroleum,16174673,0,16174673
2010,HI,Solar Thermal and Photovoltaic,0,3540,3540
2010,HI,Total,0,21672072,21672072
2010,HI,Wind,0,522240,522240
2010,HI,Wood and Wood Derived Fuels,18,0,18
2010,IA,Coal,82565875,0,82565875
2010,IA,Hydroelectric Conventional,0,1896336,1896336
2010,IA,Natural Gas,2624390,0,2624390
2010,IA,Nuclear,0,8901280,8901280
2010,IA,Other Biomass,380291,0,380291
2010,IA,Petroleum,308594,0,308594
2010,IA,Total,0,115017442,115017442
2010,IA,Wind,0,18340674,18340674
2010,ID,Coal,176556,0,176556
2010,ID,Geothermal,143682,0,143682
2010,ID,Hydroelectric Conventional,0,18308488,18308488
2010,ID,Natural Gas,3378464,0,3378464
2010,ID,Other,157452,0,157452
2010,ID,Other Biomass,47164,0,47164
2010,ID,Petroleum,148,0,148
2010,ID,Total,0,24049129,24049129
2010,ID,Wind,0,881492,881492
2010,ID,Wood and Wood Derived Fuels,955682,0,955682
2010,IL,Coal,187222730,0,187222730
2010,IL,Hydroelectric Conventional,0,237086,237086
2010,IL,Natural Gas,11447466,0,11447466
2010,IL,Nuclear,0,192379174,192379174
2010,IL,Other,600190,0,600190
2010,IL,Other Biomass,1340520,0,1340520
2010,IL,Other Gases,321290,0,321290
2010,IL,Petroleum,219488,0,219488
2010,IL,Solar Thermal and Photovoltaic,0,28290,28290
2010,IL,Total,0,402703744,402703744
2010,IL,Wind,0,8907268,8907268
2010,IL,Wood and Wood Derived Fuels,240,0,240
2010,IN,Coal,224655316,0,224655316
2010,IN,Hydroelectric Conventional,0,907424,907424
2010,IN,Natural Gas,12949972,0,12949972
2010,IN,Other,760042,0,760042
2010,IN,Other Biomass,623247,0,623247
2010,IN,Other Gases,4288280,0,4288280
2010,IN,Petroleum,309110,0,309110
2010,IN,Total,0,250361477,250361477
2010,IN,Wind,0,5868085,5868085
2010,KS,Coal,65010106,0,65010106
2010,KS,Hydroelectric Conventional,0,26428,26428
2010,KS,Natural Gas,4574646,0,4574646
2010,KS,Nuclear,0,19111424,19111424
2010,KS,Other Biomass,108572,0,108572
2010,KS,Petroleum,206220,0,206220
2010,KS,Total,0,95847525,95847525
2010,KS,Wind,0,6810130,6810130
2010,KY,Coal,182107716,0,182107716
2010,KY,Hydroelectric Conventional,0,5160492,5160492
2010,KY,Natural Gas,3681417,0,3681417
2010,KY,Other,30914,0,30914
2010,KY,Other Biomass,181606,0,181606
2010,KY,Other Gases,5324,0,5324
2010,KY,Petroleum,4569704,0,4569704
2010,KY,Total,0,196435316,196435316
2010,KY,Wood and Wood Derived Fuels,698142,0,698142
2010,LA,Coal,47847498,0,47847498
2010,LA,Hydroelectric Conventional,0,2217588,2217588
2010,LA,Natural Gas,102688158,0,102688158
2010,LA,Nuclear,0,37278694,37278694
2010,LA,Other,1118384,0,1118384
2010,LA,Other Biomass,148734,0,148734
2010,LA,Other Gases,3122319,0,3122319
2010,LA,Petroleum,6561688,0,6561688
2010,LA,Total,0,205769880,205769880
2010,LA,Wood and Wood Derived Fuels,4786818,0,4786818
2010,MA,Coal,16611781,0,16611781
2010,MA,Hydroelectric Conventional,0,1992678,1992678
2010,MA,Natural Gas,51163504,0,51163504
2010,MA,Nuclear,0,11835626,11835626
2010,MA,Other,1541258,0,1541258
2010,MA,Other Biomass,2250652,0,2250652
2010,MA,Petroleum,591473,0,591473
2010,MA,Pumped Storage,0,-674138,-674138
2010,MA,Solar Thermal and Photovoltaic,0,1855,1855
2010,MA,Total,0,85609648,85609648
2010,MA,Wind,0,44136,44136
2010,MA,Wood and Wood Derived Fuels,250824,0,250824
2010,MD,Coal,47336410,0,47336410
2010,MD,Hydroelectric Conventional,0,3334792,3334792
2010,MD,Natural Gas,5793958,0,5793958
2010,MD,Nuclear,0,27987896,27987896
2010,MD,Other,539812,0,539812
2010,MD,Other Biomass,814806,0,814806
2010,MD,Other Gases,429454,0,429454
2010,MD,Petroleum,644876,0,644876
2010,MD,Solar Thermal and Photovoltaic,0,160,160
2010,MD,Total,0,87214527,87214527
2010,MD,Wind,0,2988,2988
2010,MD,Wood and Wood Derived Fuels,329376,0,329376
2010,ME,Coal,174386,0,174386
2010,ME,Hydroelectric Conventional,0,7620762,7620762
2010,ME,Natural Gas,16747211,0,16747211
2010,ME,Other,645793,0,645793
2010,ME,Other Biomass,527017,0,527017
2010,ME,Petroleum,544600,0,544600
2010,ME,Total,0,34037319,34037319
2010,ME,Wind,0,998396,998396
2010,ME,Wood and Wood Derived Fuels,6779154,0,6779154
2010,MI,Coal,131208748,0,131208748
2010,MI,Hydroelectric Conventional,0,2501106,2501106
2010,MI,Natural Gas,24498524,0,24498524
2010,MI,Nuclear,0,59249160,59249160
2010,MI,Other,663353,0,663353
2010,MI,Other Biomass,1604752,0,1604752
2010,MI,Other Gases,598010,0,598010
2010,MI,Petroleum,764056,0,764056
2010,MI,Pumped Storage,0,-2045118,-2045118
2010,MI,Total,0,223102742,223102742
2010,MI,Wind,0,720680,720680
2010,MI,Wood and Wood Derived Fuels,3339472,0,3339472
2010,MN,Coal,56165100,0,56165100
2010,MN,Hydroelectric Conventional,0,1680820,1680820
2010,MN,Natural Gas,8681694,0,8681694
2010,MN,Nuclear,0,26956092,26956092
2010,MN,Other,515371,0,515371
2010,MN,Other Biomass,1830703,0,1830703
2010,MN,Other Gases,0,0,0
2010,MN,Petroleum,62112,0,62112
2010,MN,Total,0,107340454,107340454
2010,MN,Wind,0,9583446,9583446
2010,MN,Wood and Wood Derived Fuels,1865116,0,1865116
2010,MO,Coal,150094457,0,150094457
2010,MO,Hydroelectric Conventional,0,3078694,3078694
2010,MO,Natural Gas,9379734,0,9379734
2010,MO,Nuclear,0,17992066,17992066
2010,MO,Other,64694,0,64694
2010,MO,Other Biomass,123977,0,123977
2010,MO,Other Gases,13980,0,13980
2010,MO,Petroleum,251788,0,251788
2010,MO,Pumped Storage,0,1775372,1775372
2010,MO,Total,0,184625978,184625978
2010,MO,Wind,0,1850980,1850980
2010,MO,Wood and Wood Derived Fuels,238,0,238
2010,MS,Coal,27257994,0,27257994
2010,MS,Natural Gas,59237845,0,59237845
2010,MS,Nuclear,0,19286482,19286482
2010,MS,Other,17392,0,17392
2010,MS,Other Biomass,1982,0,1982
2010,MS,Other Gases,3270,0,3270
2010,MS,Petroleum,163000,0,163000
2010,MS,Total,0,108974521,108974521
2010,MS,Wood and Wood Derived Fuels,3006558,0,3006558
2010,MT,Coal,37201269,0,37201269
2010,MT,Hydroelectric Conventional,0,18829324,18829324
2010,MT,Natural Gas,114224,0,114224
2010,MT,Other,562428,0,562428
2010,MT,Other Gases,3798,0,3798
2010,MT,Petroleum,817003,0,817003
2010,MT,Total,0,59582361,59582361
2010,MT,Wind,0,1860466,1860466
2010,MT,Wood and Wood Derived Fuels,193848,0,193848
2010,NC,Coal,143902428,0,143902428
2010,NC,Hydroelectric Conventional,0,9513098,9513098
2010,NC,Natural Gas,16894473,0,16894473
2010,NC,Nuclear,0,81479058,81479058
2010,NC,Other,814880,0,814880
2010,NC,Other Biomass,390619,0,390619
2010,NC,Other Gases,0,0,0
2010,NC,Petroleum,586745,0,586745
2010,NC,Pumped Storage,0,0,0
2010,NC,Solar Thermal and Photovoltaic,0,22680,22680
2010,NC,Total,0,257356966,257356966
2010,NC,Wood and Wood Derived Fuels,3752984,0,3752984
2010,ND,Coal,56924081,0,56924081
2010,ND,Hydroelectric Conventional,0,4084236,4084236
2010,ND,Natural Gas,32705,0,32705
2010,ND,Other,74494,0,74494
2010,ND,Other Biomass,24774,0,24774
2010,ND,Other Gases,71072,0,71072
2010,ND,Petroleum,76440,0,76440
2010,ND,Total,0,69479084,69479084
2010,ND,Wind,0,8191282,8191282
2010,NE,Coal,46725551,0,46725551
2010,NE,Hydroelectric Conventional,0,2627712,2627712
2010,NE,Natural Gas,750070,0,750070
2010,NE,Nuclear,0,22108674,22108674
2010,NE,Other Biomass,143017,0,143017
2010,NE,Petroleum,61698,0,61698
2010,NE,Total,0,73260012,73260012
2010,NE,Wind,0,843290,843290
2010,NH,Coal,6165286,0,6165286
2010,NH,Hydroelectric Conventional,0,2955166,2955166
2010,NH,Natural Gas,10729672,0,10729672
2010,NH,Nuclear,0,21820110,21820110
2010,NH,Other,113792,0,113792
2010,NH,Other Biomass,253544,0,253544
2010,NH,Petroleum,143362,0,143362
2010,NH,Total,0,44391824,44391824
2010,NH,Wind,0,151376,151376
2010,NH,Wood and Wood Derived Fuels,2059516,0,2059516
2010,NJ,Coal,12835782,0,12835782
2010,NJ,Hydroelectric Conventional,0,36238,36238
2010,NJ,Natural Gas,49804460,0,49804460
2010,NJ,Nuclear,0,65542610,65542610
2010,NJ,Other,1150510,0,1150510
2010,NJ,Other Biomass,1632633,0,1632633
2010,NJ,Other Gases,212816,0,212816
2010,NJ,Petroleum,470008,0,470008
2010,NJ,Pumped Storage,0,-387544,-387544
2010,NJ,Solar Thermal and Photovoltaic,0,42168,42168
2010,NJ,Total,0,131364987,131364987
2010,NJ,Wind,0,25306,25306
2010,NM,Coal,51235578,0,51235578
2010,NM,Hydroelectric Conventional,0,434020,434020
2010,NM,Natural Gas,17024166,0,17024166
2010,NM,Other Biomass,27360,0,27360
2010,NM,Petroleum,99738,0,99738
2010,NM,Solar Thermal and Photovoltaic,0,17860,17860
2010,NM,Total,0,72503084,72503084
2010,NM,Wind,0,3664364,3664364
2010,NV,Coal,13994605,0,13994605
2010,NV,Geothermal,4139460,0,4139460
2010,NV,Hydroelectric Conventional,0,4314592,4314592
2010,NV,Natural Gas,47376384,0,47376384
2010,NV,Other,0,0,0
2010,NV,Other Gases,11304,0,11304
2010,NV,Petroleum,22316,0,22316
2010,NV,Solar Thermal and Photovoltaic,0,433834,433834
2010,NV,Total,0,70292496,70292496
2010,NV,Wood and Wood Derived Fuels,0,0,0
2010,NY,Coal,27165532,0,27165532
2010,NY,Hydroelectric Conventional,0,50943394,50943394
2010,NY,Natural Gas,97831090,0,97831090
2010,NY,Nuclear,0,83739070,83739070
2010,NY,Other,1663702,0,1663702
2010,NY,Other Biomass,3342179,0,3342179
2010,NY,Petroleum,4009950,0,4009950
2010,NY,Pumped Storage,0,-1058528,-1058528
2010,NY,Total,0,273923309,273923309
2010,NY,Wind,0,5192308,5192308
2010,NY,Wood and Wood Derived Fuels,1094608,0,1094608
2010,OH,Coal,235656018,0,235656018
2010,OH,Hydroelectric Conventional,0,858048,858048
2010,OH,Natural Gas,14255719,0,14255719
2010,OH,Nuclear,0,31609606,31609606
2010,OH,Other,24060,0,24060
2010,OH,Other Biomass,551710,0,551710
2010,OH,Other Gases,508198,0,508198
2010,OH,Petroleum,2884849,0,2884849
2010,OH,Solar Thermal and Photovoltaic,0,25696,25696
2010,OH,Total,0,287196674,287196674
2010,OH,Wind,0,25152,25152
2010,OH,Wood and Wood Derived Fuels,797620,0,797620
2010,OK,Coal,62950274,0,62950274
2010,OK,Hydroelectric Conventional,0,5617576,5617576
2010,OK,Natural Gas,67883363,0,67883363
2010,OK,Other,0,0,0
2010,OK,Other Biomass,194086,0,194086
2010,OK,Other Gases,0,0,0
2010,OK,Petroleum,36178,0,36178
2010,OK,Pumped Storage,0,-305836,-305836
2010,OK,Total,0,144501466,144501466
2010,OK,Wind,0,7616166,7616166
2010,OK,Wood and Wood Derived Fuels,509658,0,509658
2010,OR,Coal,8252870,0,8252870
2010,OR,Hydroelectric Conventional,0,61084520,61084520
2010,OR,Natural Gas,31302351,0,31302351
2010,OR,Other,93656,0,93656
2010,OR,Other Biomass,409864,0,409864
2010,OR,Petroleum,6841,0,6841
2010,OR,Total,0,110253998,110253998
2010,OR,Wind,0,7840014,7840014
2010,OR,Wood and Wood Derived Fuels,1263883,0,1263883
2010,PA,Coal,220738584,0,220738584
2010,PA,Hydroelectric Conventional,0,4664402,4664402
2010,PA,Natural Gas,67435216,0,67435216
2010,PA,Nuclear,0,155656696,155656696
2010,PA,Other,1689213,0,1689213
2010,PA,Other Biomass,3416712,0,3416712
2010,PA,Other Gases,1103019,0,1103019
2010,PA,Petroleum,1142690,0,1142690
2010,PA,Pumped Storage,0,-1415558,-1415558
2010,PA,Solar Thermal and Photovoltaic,0,15819,15819
2010,PA,Total,0,459504611,459504611
2010,PA,Wind,0,3708064,3708064
2010,PA,Wood and Wood Derived Fuels,1349756,0,1349756
2010,RI,Hydroelectric Conventional,0,7412,7412
2010,RI,Natural Gas,15166563,0,15166563
2010,RI,Other Biomass,273898,0,273898
2010,RI,Petroleum,23317,0,23317
2010,RI,Total,0,15477438,15477438
2010,RI,Wind,0,6248,6248
2010,SC,Coal,75342236,0,75342236
2010,SC,Hydroelectric Conventional,0,4752888,4752888
2010,SC,Natural Gas,21854474,0,21854474
2010,SC,Nuclear,0,103976158,103976158
2010,SC,Other,122328,0,122328
2010,SC,Other Biomass,261994,0,261994
2010,SC,Other Gases,0,0,0
2010,SC,Petroleum,381455,0,381455
2010,SC,Pumped Storage,0,-1869402,-1869402
2010,SC,Total,0,208306266,208306266
2010,SC,Wood and Wood Derived Fuels,3484134,0,3484134
2010,SD,Coal,6596512,0,6596512
2010,SD,Hydroelectric Conventional,0,10477602,10477602
2010,SD,Natural Gas,269412,0,269412
2010,SD,Other,0,0,0
2010,SD,Other Biomass,0,0,0
2010,SD,Petroleum,12249,0,12249
2010,SD,Total,0,20099273,20099273
2010,SD,Wind,0,2743500,2743500
2010,TN,Coal,87340392,0,87340392
2010,TN,Hydroelectric Conventional,0,16275590,16275590
2010,TN,Natural Gas,4604768,0,4604768
2010,TN,Nuclear,0,55478442,55478442
2010,TN,Other,5172,0,5172
2010,TN,Other Biomass,66246,0,66246
2010,TN,Other Gases,26924,0,26924
2010,TN,Petroleum,433806,0,433806
2010,TN,Pumped Storage,0,-1442944,-1442944
2010,TN,Total,0,164697250,164697250
2010,TN,Wind,0,81140,81140
2010,TN,Wood and Wood Derived Fuels,1827712,0,1827712
2010,TX,Coal,300345664,0,300345664
2010,TX,Hydroelectric Conventional,0,2523664,2523664
2010,TX,Natural Gas,373764475,0,373764475
2010,TX,Nuclear,0,82670496,82670496
2010,TX,Other,678034,0,678034
2010,TX,Other Biomass,1090272,0,1090272
2010,TX,Other Gases,6581140,0,6581140
2010,TX,Petroleum,1416963,0,1416963
2010,TX,Solar Thermal and Photovoltaic,0,16416,16416
2010,TX,Total,0,823390092,823390092
2010,TX,Wind,0,52502820,52502820
2010,TX,Wood and Wood Derived Fuels,1800148,0,1800148
2010,UT,Coal,68114530,0,68114530
2010,UT,Geothermal,553898,0,553898
2010,UT,Hydroelectric Conventional,0,1391024,1391024
2010,UT,Natural Gas,12910792,0,12910792
2010,UT,Other,347276,0,347276
2010,UT,Other Biomass,112676,0,112676
2010,UT,Other Gases,72440,0,72440
2010,UT,Petroleum,100714,0,100714
2010,UT,Total,0,84498709,84498709
2010,UT,Wind,0,895360,895360
2010,VA,Coal,50918442,0,50918442
2010,VA,Hydroelectric Conventional,0,3000364,3000364
2010,VA,Natural Gas,33998250,0,33998250
2010,VA,Nuclear,0,53143798,53143798
2010,VA,Other,828243,0,828243
2010,VA,Other Biomass,1630689,0,1630689
2010,VA,Petroleum,2585721,0,2585721
2010,VA,Pumped Storage,0,-2981204,-2981204
2010,VA,Total,0,145932912,145932912
2010,VA,Wood and Wood Derived Fuels,2808608,0,2808608
2010,VT,Hydroelectric Conventional,0,2693774,2693774
2010,VT,Natural Gas,7566,0,7566
2010,VT,Nuclear,0,9564946,9564946
2010,VT,Other Biomass,50162,0,50162
2010,VT,Petroleum,9018,0,9018
2010,VT,Total,0,13239980,13239980
2010,VT,Wind,0,27784,27784
2010,VT,Wood and Wood Derived Fuels,886732,0,886732
2010,WA,Coal,17053865,0,17053865
2010,WA,Hydroelectric Conventional,0,136576766,136576766
2010,WA,Natural Gas,20718470,0,20718470
2010,WA,Nuclear,0,18482266,18482266
2010,WA,Other,124518,0,124518
2010,WA,Other Biomass,392740,0,392740
2010,WA,Other Gases,584038,0,584038
2010,WA,Petroleum,64952,0,64952
2010,WA,Pumped Storage,0,106656,106656
2010,WA,Solar Thermal and Photovoltaic,0,0,0
2010,WA,Total,0,206945458,206945458
2010,WA,Wind,0,9489358,9489358
2010,WA,Wood and Wood Derived Fuels,3351830,0,3351830
2010,WI,Coal,80337466,0,80337466
2010,WI,Hydroelectric Conventional,0,4223704,4223704
2010,WI,Natural Gas,10993628,0,10993628
2010,WI,Nuclear,0,26561878,26561878
2010,WI,Other,126907,0,126907
2010,WI,Other Biomass,1015719,0,1015719
2010,WI,Other Gases,36,0,36
2010,WI,Petroleum,1436603,0,1436603
2010,WI,Total,0,128628134,128628134
2010,WI,Wind,0,2176928,2176928
2010,WI,Wood and Wood Derived Fuels,1755264,0,1755264
2010,WV,Coal,156295127,0,156295127
2010,WV,Hydroelectric Conventional,0,2734722,2734722
2010,WV,Natural Gas,279201,0,279201
2010,WV,Other,1235,0,1235
2010,WV,Other Biomass,0,0,0
2010,WV,Other Gases,80150,0,80150
2010,WV,Petroleum,309114,0,309114
2010,WV,Total,0,161577894,161577894
2010,WV,Wind,0,1878344,1878344
2010,WV,Wood and Wood Derived Fuels,0,0,0
2010,WY,Coal,85973047,0,85973047
2010,WY,Hydroelectric Conventional,0,2047774,2047774
2010,WY,Natural Gas,917966,0,917966
2010,WY,Other,135714,0,135714
2010,WY,Other Gases,558130,0,558130
2010,WY,Petroleum,112292,0,112292
2010,WY,Total,0,96238508,96238508
2010,WY,Wind,0,6493586,6493586
2011,AK,Coal,1312770.54,0,1312770.54
2011,AK,Hydroelectric Conventional,0,2689491.5,2689491.5
2011,AK,Natural Gas,7812865.26,0,7812865.26
2011,AK,Other,0,0,0
2011,AK,Other Biomass,6573.08,0,6573.08
2011,AK,Other Gases,5476.6,0,5476.6
2011,AK,Petroleum,1889996.61,0,1889996.61
2011,AK,Total,0,13742065.58,13742065.58
2011,AK,Wind,0,24892,24892
2011,AL,Coal,113614706,0,113614706
2011,AL,Hydroelectric Conventional,0,17767196,17767196
2011,AL,Natural Gas,95362107.87,0,95362107.87
2011,AL,Nuclear,0,78712244,78712244
2011,AL,Other,765005.72,0,765005.72
2011,AL,Other Biomass,19796.6,0,19796.6
2011,AL,Other Gases,583068.2,0,583068.2
2011,AL,Petroleum,240768.07,0,240768.07
2011,AL,Total,0,312678419.7,312678419.7
2011,AL,Wood and Wood Derived Fuels,5613527.18,0,5613527.18
2011,AR,Coal,58836390.91,0,58836390.91
2011,AR,Hydroelectric Conventional,0,5915690,5915690
2011,AR,Natural Gas,25893363.68,0,25893363.68
2011,AR,Nuclear,0,28388890,28388890
2011,AR,Other,64835.38,0,64835.38
2011,AR,Other Biomass,162016.48,0,162016.48
2011,AR,Petroleum,111748.44,0,111748.44
2011,AR,Pumped Storage,0,68862,68862
2011,AR,Total,0,122615071.8,122615071.8
2011,AR,Wood and Wood Derived Fuels,3173274.88,0,3173274.88
2011,AZ,Coal,87404593.38,0,87404593.38
2011,AZ,Hydroelectric Conventional,0,18348184,18348184
2011,AZ,Natural Gas,46505399.17,0,46505399.17
2011,AZ,Nuclear,0,62555726,62555726
2011,AZ,Other,29508.98,0,29508.98
2011,AZ,Other Biomass,93667.16,0,93667.16
2011,AZ,Petroleum,106490.54,0,106490.54
2011,AZ,Pumped Storage,0,242038,242038
2011,AZ,Solar Thermal and Photovoltaic,0,166697.56,166697.56
2011,AZ,Total,0,216250713.8,216250713.8
2011,AZ,Wind,0,511158,511158
2011,AZ,Wood and Wood Derived Fuels,287251,0,287251
2011,CA,Coal,3964364.78,0,3964364.78
2011,CA,Geothermal,25104766,0,25104766
2011,CA,Hydroelectric Conventional,0,85114933.76,85114933.76
2011,CA,Natural Gas,177947661.5,0,177947661.5
2011,CA,Nuclear,0,73326494,73326494
2011,CA,Other,1833848.19,0,1833848.19
2011,CA,Other Biomass,5169385.68,0,5169385.68
2011,CA,Other Gases,3333974.74,0,3333974.74
2011,CA,Petroleum,1821143.12,0,1821143.12
2011,CA,Pumped Storage,0,-177586,-177586
2011,CA,Solar Thermal and Photovoltaic,0,1777658.8,1777658.8
2011,CA,Total,0,401609685,401609685
2011,CA,Wind,0,15503674,15503674
2011,CA,Wood and Wood Derived Fuels,6889366.44,0,6889366.44
2011,CO,Coal,67909373.16,0,67909373.16
2011,CO,Hydroelectric Conventional,0,4165242.8,4165242.8
2011,CO,Natural Gas,20372606.52,0,20372606.52
2011,CO,Other,126908,0,126908
2011,CO,Other Biomass,123040.14,0,123040.14
2011,CO,Petroleum,44436.82,0,44436.82
2011,CO,Pumped Storage,0,-486758,-486758
2011,CO,Solar Thermal and Photovoltaic,0,209271.22,209271.22
2011,CO,Total,0,102865108.6,102865108.6
2011,CO,Wind,0,10400643.66,10400643.66
2011,CO,Wood and Wood Derived Fuels,344.26,0,344.26
2011,CT,Coal,1051613.08,0,1051613.08
2011,CT,Hydroelectric Conventional,0,1134884,1134884
2011,CT,Natural Gas,30376290.52,0,30376290.52
2011,CT,Nuclear,0,31855674,31855674
2011,CT,Other,1409734.3,0,1409734.3
2011,CT,Other Biomass,1317745.92,0,1317745.92
2011,CT,Petroleum,331620.02,0,331620.02
2011,CT,Pumped Storage,0,11208,11208
2011,CT,Total,0,67490441.21,67490441.21
2011,CT,Wood and Wood Derived Fuels,1671.36,0,1671.36
2011,DC,Natural Gas,142397.92,0,142397.92
2011,DC,Petroleum,259350,0,259350
2011,DC,Total,0,401747.92,401747.92
2011,DE,Coal,2909991.76,0,2909991.76
2011,DE,Natural Gas,9462737.98,0,9462737.98
2011,DE,Other,0,0,0
2011,DE,Other Biomass,289463.34,0,289463.34
2011,DE,Other Gases,416508,0,416508
2011,DE,Petroleum,75478.92,0,75478.92
2011,DE,Solar Thermal and Photovoltaic,0,16559.6,16559.6
2011,DE,Total,0,13180389.6,13180389.6
2011,DE,Wind,0,9650,9650
2011,FL,Coal,103981921.9,0,103981921.9
2011,FL,Hydroelectric Conventional,0,364084,364084
2011,FL,Natural Gas,272727747.4,0,272727747.4
2011,FL,Nuclear,0,44030736,44030736
2011,FL,Other,6770101.66,0,6770101.66
2011,FL,Other Biomass,4669969.47,0,4669969.47
2011,FL,Other Gases,12382.42,0,12382.42
2011,FL,Petroleum,6561887.85,0,6561887.85
2011,FL,Solar Thermal and Photovoltaic,0,251452,251452
2011,FL,Total,0,443789148.2,443789148.2
2011,FL,Wood and Wood Derived Fuels,4418865.48,0,4418865.48
2011,GA,Coal,120318680.5,0,120318680.5
2011,GA,Hydroelectric Conventional,0,5410115.1,5410115.1
2011,GA,Natural Gas,53087208.52,0,53087208.52
2011,GA,Nuclear,0,64612362,64612362
2011,GA,Other,55734.96,0,55734.96
2011,GA,Other Biomass,238525.86,0,238525.86
2011,GA,Petroleum,1102576.02,0,1102576.02
2011,GA,Pumped Storage,0,-1467034,-1467034
2011,GA,Total,0,249498682.3,249498682.3
2011,GA,Wood and Wood Derived Fuels,6140513.32,0,6140513.32
2011,HI,Coal,2848071.38,0,2848071.38
2011,HI,Geothermal,447776,0,447776
2011,HI,Hydroelectric Conventional,0,186281.46,186281.46
2011,HI,Natural Gas,0,0,0
2011,HI,Other,732122.32,0,732122.32
2011,HI,Other Biomass,625253.84,0,625253.84
2011,HI,Other Gases,70500.34,0,70500.34
2011,HI,Petroleum,15847850.48,0,15847850.48
2011,HI,Solar Thermal and Photovoltaic,0,7186,7186
2011,HI,Total,0,21446665.82,21446665.82
2011,HI,Wind,0,681624,681624
2011,HI,Wood and Wood Derived Fuels,0,0,0
2011,IA,Coal,76458719.96,0,76458719.96
2011,IA,Hydroelectric Conventional,0,1850704,1850704
2011,IA,Natural Gas,1982365.22,0,1982365.22
2011,IA,Nuclear,0,10430458,10430458
2011,IA,Other Biomass,321183.42,0,321183.42
2011,IA,Petroleum,282040.88,0,282040.88
2011,IA,Total,0,112743825.3,112743825.3
2011,IA,Wind,0,21418353.82,21418353.82
2011,ID,Coal,166823.98,0,166823.98
2011,ID,Geothermal,126980,0,126980
2011,ID,Hydroelectric Conventional,0,26809598,26809598
2011,ID,Natural Gas,2221487.38,0,2221487.38
2011,ID,Other,155262,0,155262
2011,ID,Other Biomass,95235.8,0,95235.8
2011,ID,Petroleum,52,0,52
2011,ID,Total,0,33137571.8,33137571.8
2011,ID,Wind,0,2613364,2613364
2011,ID,Wood and Wood Derived Fuels,948768.64,0,948768.64
2011,IL,Coal,180026650.8,0,180026650.8
2011,IL,Hydroelectric Conventional,0,280924,280924
2011,IL,Natural Gas,11911599.74,0,11911599.74
2011,IL,Nuclear,0,191646392,191646392
2011,IL,Other,597724.54,0,597724.54
2011,IL,Other Biomass,1275160.88,0,1275160.88
2011,IL,Other Gases,637097.03,0,637097.03
2011,IL,Petroleum,168480.65,0,168480.65
2011,IL,Solar Thermal and Photovoltaic,0,28124,28124
2011,IL,Total,0,398999456.1,398999456.1
2011,IL,Wind,0,12426264,12426264
2011,IL,Wood and Wood Derived Fuels,1038.5,0,1038.5
2011,IN,Coal,208305196.5,0,208305196.5
2011,IN,Hydroelectric Conventional,0,817558,817558
2011,IN,Natural Gas,20127936.57,0,20127936.57
2011,IN,Other,738105.5,0,738105.5
2011,IN,Other Biomass,671175.11,0,671175.11
2011,IN,Other Gases,4366774.9,0,4366774.9
2011,IN,Petroleum,2665259.34,0,2665259.34
2011,IN,Total,0,244262827.9,244262827.9
2011,IN,Wind,0,6570822,6570822
2011,KS,Coal,63311697.7,0,63311697.7
2011,KS,Hydroelectric Conventional,0,29490,29490
2011,KS,Natural Gas,5070174.74,0,5070174.74
2011,KS,Nuclear,0,14637776,14637776
2011,KS,Other Biomass,117506,0,117506
2011,KS,Petroleum,113077.8,0,113077.8
2011,KS,Total,0,90719680.24,90719680.24
2011,KS,Wind,0,7439958,7439958
2011,KY,Coal,183312059.3,0,183312059.3
2011,KY,Hydroelectric Conventional,0,5938624,5938624
2011,KY,Natural Gas,3091010.9,0,3091010.9
2011,KY,Other,17909.62,0,17909.62
2011,KY,Other Biomass,189916.28,0,189916.28
2011,KY,Petroleum,3469899.52,0,3469899.52
2011,KY,Total,0,196701964.4,196701964.4
2011,KY,Wood and Wood Derived Fuels,682544.74,0,682544.74
2011,LA,Coal,49255038.92,0,49255038.92
2011,LA,Hydroelectric Conventional,0,2088038,2088038
2011,LA,Natural Gas,108644928.4,0,108644928.4
2011,LA,Nuclear,0,33229950,33229950
2011,LA,Other,879139.56,0,879139.56
2011,LA,Other Biomass,142186.92,0,142186.92
2011,LA,Other Gases,2584363.62,0,2584363.62
2011,LA,Petroleum,9414953.72,0,9414953.72
2011,LA,Total,0,210981473.9,210981473.9
2011,LA,Wood and Wood Derived Fuels,4742874.76,0,4742874.76
2011,MA,Coal,8117614.72,0,8117614.72
2011,MA,Hydroelectric Conventional,0,2297523.92,2297523.92
2011,MA,Natural Gas,51879344.13,0,51879344.13
2011,MA,Nuclear,0,10170440,10170440
2011,MA,Other,1719028.36,0,1719028.36
2011,MA,Other Biomass,2078259.11,0,2078259.11
2011,MA,Petroleum,393005.22,0,393005.22
2011,MA,Pumped Storage,0,-880462,-880462
2011,MA,Solar Thermal and Photovoltaic,0,9528.94,9528.94
2011,MA,Total,0,76109641.03,76109641.03
2011,MA,Wind,0,122769.58,122769.58
2011,MA,Wood and Wood Derived Fuels,202589.08,0,202589.08
2011,MD,Coal,42117872.38,0,42117872.38
2011,MD,Hydroelectric Conventional,0,5094246,5094246
2011,MD,Natural Gas,4621320.94,0,4621320.94
2011,MD,Nuclear,0,28794874,28794874
2011,MD,Other,597126.78,0,597126.78
2011,MD,Other Biomass,759779.75,0,759779.75
2011,MD,Other Gases,309280.52,0,309280.52
2011,MD,Petroleum,457933.46,0,457933.46
2011,MD,Solar Thermal and Photovoltaic,0,5412,5412
2011,MD,Total,0,83636136.38,83636136.38
2011,MD,Wind,0,541426,541426
2011,MD,Wood and Wood Derived Fuels,336864.54,0,336864.54
2011,ME,Coal,110332.66,0,110332.66
2011,ME,Hydroelectric Conventional,0,7957955.76,7957955.76
2011,ME,Natural Gas,13753662.53,0,13753662.53
2011,ME,Other,780907.5,0,780907.5
2011,ME,Other Biomass,553273.24,0,553273.24
2011,ME,Petroleum,355129.72,0,355129.72
2011,ME,Total,0,31947376.12,31947376.12
2011,ME,Wind,0,1413279.04,1413279.04
2011,ME,Wood and Wood Derived Fuels,7022835.68,0,7022835.68
2011,MI,Coal,117896538.4,0,117896538.4
2011,MI,Hydroelectric Conventional,0,2714616,2714616
2011,MI,Natural Gas,25964107.81,0,25964107.81
2011,MI,Nuclear,0,65778934,65778934
2011,MI,Other,726312.92,0,726312.92
2011,MI,Other Biomass,1654487.42,0,1654487.42
2011,MI,Other Gases,538350.48,0,538350.48
2011,MI,Petroleum,685538.91,0,685538.91
2011,MI,Pumped Storage,0,-1890034,-1890034
2011,MI,Total,0,218339013.7,218339013.7
2011,MI,Wind,0,912948,912948
2011,MI,Wood and Wood Derived Fuels,3357213.87,0,3357213.87
2011,MN,Coal,56517251.44,0,56517251.44
2011,MN,Hydroelectric Conventional,0,1492296.06,1492296.06
2011,MN,Natural Gas,6701546.66,0,6701546.66
2011,MN,Nuclear,0,23917050,23917050
2011,MN,Other,723941.76,0,723941.76
2011,MN,Other Biomass,1864410.79,0,1864410.79
2011,MN,Other Gases,0,0,0
2011,MN,Petroleum,75814.08,0,75814.08
2011,MN,Total,0,106240123,106240123
2011,MN,Wind,0,13451390.86,13451390.86
2011,MN,Wood and Wood Derived Fuels,1496421.34,0,1496421.34
2011,MO,Coal,156631700.5,0,156631700.5
2011,MO,Hydroelectric Conventional,0,2370288,2370288
2011,MO,Natural Gas,9096459.58,0,9096459.58
2011,MO,Nuclear,0,18742646,18742646
2011,MO,Other,42773.52,0,42773.52
2011,MO,Other Biomass,124293.58,0,124293.58
2011,MO,Petroleum,159608.02,0,159608.02
2011,MO,Pumped Storage,0,228508,228508
2011,MO,Total,0,189752793.4,189752793.4
2011,MO,Wind,0,2356424,2356424
2011,MO,Wood and Wood Derived Fuels,92.18,0,92.18
2011,MS,Coal,19446221.58,0,19446221.58
2011,MS,Natural Gas,59931217.28,0,59931217.28
2011,MS,Nuclear,0,20673578,20673578
2011,MS,Other,6033.38,0,6033.38
2011,MS,Other Biomass,6594.86,0,6594.86
2011,MS,Petroleum,72682.06,0,72682.06
2011,MS,Total,0,103141885.3,103141885.3
2011,MS,Wood and Wood Derived Fuels,3005558.16,0,3005558.16
2011,MT,Coal,30111444.62,0,30111444.62
2011,MT,Hydroelectric Conventional,0,25191762.68,25191762.68
2011,MT,Natural Gas,836385.36,0,836385.36
2011,MT,Other,665866,0,665866
2011,MT,Other Gases,39.16,0,39.16
2011,MT,Petroleum,921252.1,0,921252.1
2011,MT,Total,0,60257085.14,60257085.14
2011,MT,Wind,0,2530335.22,2530335.22
2011,NC,Coal,119516714.3,0,119516714.3
2011,NC,Hydroelectric Conventional,0,7786792,7786792
2011,NC,Natural Gas,22310422.04,0,22310422.04
2011,NC,Nuclear,0,81053668,81053668
2011,NC,Other,985873.44,0,985873.44
2011,NC,Other Biomass,750426.56,0,750426.56
2011,NC,Petroleum,435271.19,0,435271.19
2011,NC,Pumped Storage,0,0,0
2011,NC,Solar Thermal and Photovoltaic,0,34760.9,34760.9
2011,NC,Total,0,236779709.8,236779709.8
2011,NC,Wood and Wood Derived Fuels,3905781.44,0,3905781.44
2011,ND,Coal,54217852.38,0,54217852.38
2011,ND,Hydroelectric Conventional,0,5160084,5160084
2011,ND,Natural Gas,39804.65,0,39804.65
2011,ND,Other,88597.66,0,88597.66
2011,ND,Other Biomass,19724,0,19724
2011,ND,Other Gases,78319.58,0,78319.58
2011,ND,Petroleum,84237.92,0,84237.92
2011,ND,Total,0,70159800.2,70159800.2
2011,ND,Wind,0,10471180,10471180
2011,NE,Coal,51930485.78,0,51930485.78
2011,NE,Hydroelectric Conventional,0,3234456,3234456
2011,NE,Natural Gas,851789.57,0,851789.57
2011,NE,Nuclear,0,13866348,13866348
2011,NE,Other Biomass,130839,0,130839
2011,NE,Petroleum,74413.66,0,74413.66
2011,NE,Total,0,72190102,72190102
2011,NE,Wind,0,2101770,2101770
2011,NH,Coal,4416406.72,0,4416406.72
2011,NH,Hydroelectric Conventional,0,3209622,3209622
2011,NH,Natural Gas,13315138.87,0,13315138.87
2011,NH,Nuclear,0,16725614,16725614
2011,NH,Other,127643.52,0,127643.52
2011,NH,Other Biomass,216118.36,0,216118.36
2011,NH,Petroleum,155011.14,0,155011.14
2011,NH,Total,0,40131882,40131882
2011,NH,Wind,0,132184,132184
2011,NH,Wood and Wood Derived Fuels,1834143.4,0,1834143.4
2011,NJ,Coal,8310194.03,0,8310194.03
2011,NJ,Hydroelectric Conventional,0,48814,48814
2011,NJ,Natural Gas,50402149.9,0,50402149.9
2011,NJ,Nuclear,0,67212894,67212894
2011,NJ,Other,1287146.2,0,1287146.2
2011,NJ,Other Biomass,1752222.35,0,1752222.35
2011,NJ,Other Gases,278350.35,0,278350.35
2011,NJ,Petroleum,331175.91,0,331175.91
2011,NJ,Pumped Storage,0,-393556,-393556
2011,NJ,Solar Thermal and Photovoltaic,0,137755.22,137755.22
2011,NJ,Total,0,129388191.9,129388191.9
2011,NJ,Wind,0,21046,21046
2011,NM,Coal,54281726.86,0,54281726.86
2011,NM,Hydroelectric Conventional,0,389532,389532
2011,NM,Natural Gas,17131967.49,0,17131967.49
2011,NM,Other Biomass,18852.84,0,18852.84
2011,NM,Petroleum,75601.42,0,75601.42
2011,NM,Solar Thermal and Photovoltaic,0,255604,255604
2011,NM,Total,0,76362278.6,76362278.6
2011,NM,Wind,0,4208994,4208994
2011,NV,Coal,10814608.62,0,10814608.62
2011,NV,Geothermal,4292238,0,4292238
2011,NV,Hydroelectric Conventional,0,4381166,4381166
2011,NV,Natural Gas,43682793.08,0,43682793.08
2011,NV,Other,75634,0,75634
2011,NV,Other Gases,14521.74,0,14521.74
2011,NV,Petroleum,28425.34,0,28425.34
2011,NV,Solar Thermal and Photovoltaic,0,582449.02,582449.02
2011,NV,Total,0,63871835.82,63871835.82
2011,NV,Wood and Wood Derived Fuels,0,0,0
2011,NY,Coal,18852320.38,0,18852320.38
2011,NY,Hydroelectric Conventional,0,55993975.24,55993975.24
2011,NY,Natural Gas,101609509.7,0,101609509.7
2011,NY,Nuclear,0,85390018,85390018
2011,NY,Other,1810374.18,0,1810374.18
2011,NY,Other Biomass,3238298.02,0,3238298.02
2011,NY,Petroleum,2378961.36,0,2378961.36
2011,NY,Pumped Storage,0,-866042,-866042
2011,NY,Solar Thermal and Photovoltaic,0,12886,12886
2011,NY,Total,0,274960693.9,274960693.9
2011,NY,Wind,0,5656138,5656138
2011,NY,Wood and Wood Derived Fuels,884255.02,0,884255.02
2011,OH,Coal,210673914.2,0,210673914.2
2011,OH,Hydroelectric Conventional,0,767310,767310
2011,OH,Natural Gas,24675154.21,0,24675154.21
2011,OH,Nuclear,0,29779492,29779492
2011,OH,Other,20005.44,0,20005.44
2011,OH,Other Biomass,663511.14,0,663511.14
2011,OH,Other Gases,607485.22,0,607485.22
2011,OH,Petroleum,2776864.84,0,2776864.84
2011,OH,Solar Thermal and Photovoltaic,0,30990,30990
2011,OH,Total,0,271171608.9,271171608.9
2011,OH,Wind,0,396886,396886
2011,OH,Wood and Wood Derived Fuels,779995.86,0,779995.86
2011,OK,Coal,68957894,0,68957894
2011,OK,Hydroelectric Conventional,0,3013882,3013882
2011,OK,Natural Gas,65673400.32,0,65673400.32
2011,OK,Other,3081.12,0,3081.12
2011,OK,Other Biomass,174484.02,0,174484.02
2011,OK,Petroleum,31096.76,0,31096.76
2011,OK,Pumped Storage,0,-306390,-306390
2011,OK,Total,0,149211427.2,149211427.2
2011,OK,Wind,0,11210530,11210530
2011,OK,Wood and Wood Derived Fuels,453449.02,0,453449.02
2011,OR,Coal,6667032.4,0,6667032.4
2011,OR,Hydroelectric Conventional,0,84629642,84629642
2011,OR,Natural Gas,16995459.08,0,16995459.08
2011,OR,Other,102651.26,0,102651.26
2011,OR,Other Biomass,444510,0,444510
2011,OR,Petroleum,15907.9,0,15907.9
2011,OR,Solar Thermal and Photovoltaic,0,180,180
2011,OR,Total,0,119390328.3,119390328.3
2011,OR,Wind,0,9550748,9550748
2011,OR,Wood and Wood Derived Fuels,984197.61,0,984197.61
2011,PA,Coal,201206163,0,201206163
2011,PA,Hydroelectric Conventional,0,6434432,6434432
2011,PA,Natural Gas,83584329.91,0,83584329.91
2011,PA,Nuclear,0,152293234,152293234
2011,PA,Other,1785050.65,0,1785050.65
2011,PA,Other Biomass,3306891.69,0,3306891.69
2011,PA,Other Gases,1232326.52,0,1232326.52
2011,PA,Petroleum,883448.55,0,883448.55
2011,PA,Pumped Storage,0,-987520,-987520
2011,PA,Solar Thermal and Photovoltaic,0,46288.06,46288.06
2011,PA,Total,0,454629444.7,454629444.7
2011,PA,Wind,0,3588930,3588930
2011,PA,Wood and Wood Derived Fuels,1255870.32,0,1255870.32
2011,RI,Hydroelectric Conventional,0,14822,14822
2011,RI,Natural Gas,17141808.46,0,17141808.46
2011,RI,Other Biomass,254810,0,254810
2011,RI,Petroleum,27280.65,0,27280.65
2011,RI,Total,0,17444545.1,17444545.1
2011,RI,Wind,0,5824,5824
2011,SC,Coal,68337097.94,0,68337097.94
2011,SC,Hydroelectric Conventional,0,3108362,3108362
2011,SC,Natural Gas,25872685.19,0,25872685.19
2011,SC,Nuclear,0,105805152,105805152
2011,SC,Other,120670.56,0,120670.56
2011,SC,Other Biomass,282188,0,282188
2011,SC,Petroleum,223116.35,0,223116.35
2011,SC,Pumped Storage,0,-1780286,-1780286
2011,SC,Total,0,205945134.3,205945134.3
2011,SC,Wood and Wood Derived Fuels,3976148.32,0,3976148.32
2011,SD,Coal,5171130.12,0,5171130.12
2011,SD,Hydroelectric Conventional,0,13216328,13216328
2011,SD,Natural Gas,258626.46,0,258626.46
2011,SD,Other,0,0,0
2011,SD,Other Biomass,0,0,0
2011,SD,Petroleum,15086.42,0,15086.42
2011,SD,Total,0,23997771,23997771
2011,SD,Wind,0,5336600,5336600
2011,TN,Coal,81554448.52,0,81554448.52
2011,TN,Hydroelectric Conventional,0,19151278,19151278
2011,TN,Natural Gas,6518717.61,0,6518717.61
2011,TN,Nuclear,0,53838354,53838354
2011,TN,Other,2204.58,0,2204.58
2011,TN,Other Biomass,72359.74,0,72359.74
2011,TN,Other Gases,33378.58,0,33378.58
2011,TN,Petroleum,390523.95,0,390523.95
2011,TN,Pumped Storage,0,-1320734,-1320734
2011,TN,Total,0,162207724.5,162207724.5
2011,TN,Wind,0,106286,106286
2011,TN,Wood and Wood Derived Fuels,1860907.48,0,1860907.48
2011,TX,Coal,315793070.4,0,315793070.4
2011,TX,Hydroelectric Conventional,0,1126107.44,1126107.44
2011,TX,Natural Gas,401000297.9,0,401000297.9
2011,TX,Nuclear,0,79296914,79296914
2011,TX,Other,637900.56,0,637900.56
2011,TX,Other Biomass,1356253.43,0,1356253.43
2011,TX,Other Gases,6779679.65,0,6779679.65
2011,TX,Petroleum,1953610.41,0,1953610.41
2011,TX,Solar Thermal and Photovoltaic,0,57278,57278
2011,TX,Total,0,870953847.2,870953847.2
2011,TX,Wind,0,61096174.46,61096174.46
2011,TX,Wood and Wood Derived Fuels,1856561,0,1856561
2011,UT,Coal,66275326.51,0,66275326.51
2011,UT,Geothermal,660376,0,660376
2011,UT,Hydroelectric Conventional,0,2460330,2460330
2011,UT,Natural Gas,10512092.7,0,10512092.7
2011,UT,Other,329406.34,0,329406.34
2011,UT,Other Biomass,116013.68,0,116013.68
2011,UT,Other Gases,65276.48,0,65276.48
2011,UT,Petroleum,107898.32,0,107898.32
2011,UT,Total,0,81672300.02,81672300.02
2011,UT,Wind,0,1145580,1145580
2011,VA,Coal,39762226.89,0,39762226.89
2011,VA,Hydroelectric Conventional,0,2420778,2420778
2011,VA,Natural Gas,36664746.32,0,36664746.32
2011,VA,Nuclear,0,51095994,51095994
2011,VA,Other,940477.11,0,940477.11
2011,VA,Other Biomass,1579275.66,0,1579275.66
2011,VA,Petroleum,1005292.68,0,1005292.68
2011,VA,Pumped Storage,0,-2939078,-2939078
2011,VA,Total,0,133341718.1,133341718.1
2011,VA,Wood and Wood Derived Fuels,2812005.5,0,2812005.5
2011,VT,Hydroelectric Conventional,0,2849466,2849466
2011,VT,Natural Gas,6554.74,0,6554.74
2011,VT,Nuclear,0,9814710,9814710
2011,VT,Other Biomass,50896,0,50896
2011,VT,Petroleum,16315.67,0,16315.67
2011,VT,Solar Thermal and Photovoltaic,0,3630,3630
2011,VT,Total,0,13552437.62,13552437.62
2011,VT,Wind,0,66370,66370
2011,VT,Wood and Wood Derived Fuels,744495.22,0,744495.22
2011,WA,Coal,10457170.1,0,10457170.1
2011,WA,Hydroelectric Conventional,0,183635403.4,183635403.4
2011,WA,Natural Gas,9699014.68,0,9699014.68
2011,WA,Nuclear,0,9612556,9612556
2011,WA,Other,319829.74,0,319829.74
2011,WA,Other Biomass,337743.5,0,337743.5
2011,WA,Other Gases,594416.72,0,594416.72
2011,WA,Petroleum,74294.54,0,74294.54
2011,WA,Pumped Storage,0,103832,103832
2011,WA,Solar Thermal and Photovoltaic,0,1680,1680
2011,WA,Total,0,230525201.6,230525201.6
2011,WA,Wind,0,12524760,12524760
2011,WA,Wood and Wood Derived Fuels,3164500.95,0,3164500.95
2011,WI,Coal,79875474.64,0,79875474.64
2011,WI,Hydroelectric Conventional,0,4293819.78,4293819.78
2011,WI,Natural Gas,12486672.84,0,12486672.84
2011,WI,Nuclear,0,23119562,23119562
2011,WI,Other,108418.94,0,108418.94
2011,WI,Other Biomass,1090825.66,0,1090825.66
2011,WI,Petroleum,1164717.53,0,1164717.53
2011,WI,Total,0,126578687.5,126578687.5
2011,WI,Wind,0,2375460,2375460
2011,WI,Wood and Wood Derived Fuels,2063736.19,0,2063736.19
2011,WV,Coal,151928214.7,0,151928214.7
2011,WV,Hydroelectric Conventional,0,2906218,2906218
2011,WV,Natural Gas,502929,0,502929
2011,WV,Other,89.48,0,89.48
2011,WV,Other Biomass,18382,0,18382
2011,WV,Other Gases,60955.92,0,60955.92
2011,WV,Petroleum,376962.5,0,376962.5
2011,WV,Total,0,157999247.1,157999247.1
2011,WV,Wind,0,2205024.62,2205024.62
2011,WV,Wood and Wood Derived Fuels,470.86,0,470.86
2011,WY,Coal,81922897.39,0,81922897.39
2011,WY,Hydroelectric Conventional,0,2447460,2447460
2011,WY,Natural Gas,917860.28,0,917860.28
2011,WY,Other,124213.22,0,124213.22
2011,WY,Other Gases,529873.9,0,529873.9
2011,WY,Petroleum,110900.89,0,110900.89
2011,WY,Total,0,95276941.66,95276941.66
2011,WY,Wind,0,9223736,9223736
2012,AK,Coal,1369918,0,1369918
2012,AK,Hydroelectric Conventional,0,3150090,3150090
2012,AK,Natural Gas,7212075,0,7212075
2012,AK,Other,0,0,0
2012,AK,Other Biomass,5130,0,5130
2012,AK,Other Gases,5316,0,5316
2012,AK,Petroleum,2075524,0,2075524
2012,AK,Total,0,13892838,13892838
2012,AK,Wind,0,74784,74784
2012,AL,Coal,91213840,0,91213840
2012,AL,Hydroelectric Conventional,0,14870446,14870446
2012,AL,Natural Gas,111409999,0,111409999
2012,AL,Nuclear,0,81682424,81682424
2012,AL,Other,453086,0,453086
2012,AL,Other Biomass,15578,0,15578
2012,AL,Other Gases,355304,0,355304
2012,AL,Petroleum,219167,0,219167
2012,AL,Total,0,305757376,305757376
2012,AL,Wood and Wood Derived Fuels,5537530,0,5537530
2012,AR,Coal,56861860,0,56861860
2012,AR,Hydroelectric Conventional,0,4396944,4396944
2012,AR,Natural Gas,34234826,0,34234826
2012,AR,Nuclear,0,30986262,30986262
2012,AR,Other,60784,0,60784
2012,AR,Other Biomass,140958,0,140958
2012,AR,Petroleum,65119,0,65119
2012,AR,Pumped Storage,0,84820,84820
2012,AR,Total,0,130011356,130011356
2012,AR,Wood and Wood Derived Fuels,3179782,0,3179782
2012,AZ,Coal,80231330,0,80231330
2012,AZ,Hydroelectric Conventional,0,13433868,13433868
2012,AZ,Natural Gas,60590020,0,60590020
2012,AZ,Nuclear,0,63867832,63867832
2012,AZ,Other,48918,0,48918
2012,AZ,Other Biomass,107744,0,107744
2012,AZ,Petroleum,83824,0,83824
2012,AZ,Pumped Storage,0,158890,158890
2012,AZ,Solar Thermal and Photovoltaic,0,1910886,1910886
2012,AZ,Total,0,221809987,221809987
2012,AZ,Wind,0,1063280,1063280
2012,AZ,Wood and Wood Derived Fuels,313394,0,313394
2012,CA,Coal,2750166,0,2750166
2012,CA,Geothermal,25037998,0,25037998
2012,CA,Hydroelectric Conventional,0,53674740,53674740
2012,CA,Natural Gas,239336659,0,239336659
2012,CA,Nuclear,0,37014816,37014816
2012,CA,Other,1629371,0,1629371
2012,CA,Other Biomass,5027443,0,5027443
2012,CA,Other Gases,2968327,0,2968327
2012,CA,Petroleum,579646,0,579646
2012,CA,Pumped Storage,0,1149718,1149718
2012,CA,Solar Thermal and Photovoltaic,0,2764600,2764600
2012,CA,Total,0,399037134,399037134
2012,CA,Wind,0,19508460,19508460
2012,CA,Wood and Wood Derived Fuels,7595192,0,7595192
2012,CO,Coal,69042041,0,69042041
2012,CO,Hydroelectric Conventional,0,2994418,2994418
2012,CO,Natural Gas,21048890,0,21048890
2012,CO,Other,110736,0,110736
2012,CO,Other Biomass,115444,0,115444
2012,CO,Petroleum,22090,0,22090
2012,CO,Pumped Storage,0,-488936,-488936
2012,CO,Solar Thermal and Photovoltaic,0,330898,330898
2012,CO,Total,0,105113403,105113403
2012,CO,Wind,0,11937286,11937286
2012,CO,Wood and Wood Derived Fuels,534,0,534
2012,CT,Coal,1305772,0,1305772
2012,CT,Hydroelectric Conventional,0,624282,624282
2012,CT,Natural Gas,33074337,0,33074337
2012,CT,Nuclear,0,34155774,34155774
2012,CT,Other,1512974,0,1512974
2012,CT,Other Biomass,1331578,0,1331578
2012,CT,Petroleum,223465,0,223465
2012,CT,Pumped Storage,0,5432,5432
2012,CT,Total,0,72235088,72235088
2012,CT,Wood and Wood Derived Fuels,1472,0,1472
2012,DC,Natural Gas,124776,0,124776
2012,DC,Petroleum,18798,0,18798
2012,DC,Total,0,143574,143574
2012,DE,Coal,2845406,0,2845406
2012,DE,Natural Gas,13629455,0,13629455
2012,DE,Other Biomass,209708,0,209708
2012,DE,Other Gases,487178,0,487178
2012,DE,Petroleum,43248,0,43248
2012,DE,Solar Thermal and Photovoltaic,0,45118,45118
2012,DE,Total,0,17267388,17267388
2012,DE,Wind,0,7276,7276
2012,FL,Coal,88572782,0,88572782
2012,FL,Hydroelectric Conventional,0,301022,301022
2012,FL,Natural Gas,299399283,0,299399283
2012,FL,Nuclear,0,35739870,35739870
2012,FL,Other,6387560,0,6387560
2012,FL,Other Biomass,4545242,0,4545242
2012,FL,Other Gases,12108,0,12108
2012,FL,Petroleum,2732051,0,2732051
2012,FL,Solar Thermal and Photovoltaic,0,387232,387232
2012,FL,Total,0,442192273,442192273
2012,FL,Wood and Wood Derived Fuels,4115121,0,4115121
2012,GA,Coal,81430098,0,81430098
2012,GA,Hydroelectric Conventional,0,4472600,4472600
2012,GA,Natural Gas,85077202,0,85077202
2012,GA,Nuclear,0,67883268,67883268
2012,GA,Other,112110,0,112110
2012,GA,Other Biomass,336244,0,336244
2012,GA,Petroleum,756145,0,756145
2012,GA,Pumped Storage,0,-1675768,-1675768
2012,GA,Solar Thermal and Photovoltaic,0,5842,5842
2012,GA,Total,0,244612728,244612728
2012,GA,Wood and Wood Derived Fuels,6214988,0,6214988
2012,HI,Coal,3074680,0,3074680
2012,HI,Geothermal,521994,0,521994
2012,HI,Hydroelectric Conventional,0,229162,229162
2012,HI,Other,725471,0,725471
2012,HI,Other Biomass,561952,0,561952
2012,HI,Other Gases,94072,0,94072
2012,HI,Petroleum,14965520,0,14965520
2012,HI,Solar Thermal and Photovoltaic,0,9216,9216
2012,HI,Total,0,20938538,20938538
2012,HI,Wind,0,756468,756468
2012,HI,Wood and Wood Derived Fuels,0,0,0
2012,IA,Coal,70662702,0,70662702
2012,IA,Hydroelectric Conventional,0,1532382,1532382
2012,IA,Natural Gas,3881772,0,3881772
2012,IA,Nuclear,0,8693990,8693990
2012,IA,Other Biomass,301867,0,301867
2012,IA,Petroleum,213114,0,213114
2012,IA,Total,0,113350811,113350811
2012,IA,Wind,0,28064984,28064984
2012,ID,Coal,153474,0,153474
2012,ID,Geothermal,149352,0,149352
2012,ID,Hydroelectric Conventional,0,21880810,21880810
2012,ID,Natural Gas,3796334,0,3796334
2012,ID,Other,138518,0,138518
2012,ID,Other Biomass,179372,0,179372
2012,ID,Petroleum,38,0,38
2012,ID,Total,0,30998178,30998178
2012,ID,Wind,0,3781118,3781118
2012,ID,Wood and Wood Derived Fuels,919162,0,919162
2012,IL,Coal,161653555,0,161653555
2012,IL,Hydroelectric Conventional,0,222416,222416
2012,IL,Natural Gas,22377950,0,22377950
2012,IL,Nuclear,0,192802618,192802618
2012,IL,Other,598922,0,598922
2012,IL,Other Biomass,1230386,0,1230386
2012,IL,Other Gases,587180,0,587180
2012,IL,Petroleum,142764,0,142764
2012,IL,Solar Thermal and Photovoltaic,0,61314,61314
2012,IL,Total,0,395130725,395130725
2012,IL,Wind,0,15453618,15453618
2012,IL,Wood and Wood Derived Fuels,0,0,0
2012,IN,Coal,184922384,0,184922384
2012,IN,Hydroelectric Conventional,0,867010,867010
2012,IN,Natural Gas,28941810,0,28941810
2012,IN,Other,693141,0,693141
2012,IN,Other Biomass,672185,0,672185
2012,IN,Other Gases,4982850,0,4982850
2012,IN,Petroleum,1891530,0,1891530
2012,IN,Solar Thermal and Photovoltaic,0,342,342
2012,IN,Total,0,229391459,229391459
2012,IN,Wind,0,6420208,6420208
2012,KS,Coal,55965062,0,55965062
2012,KS,Hydroelectric Conventional,0,20798,20798
2012,KS,Natural Gas,5719624,0,5719624
2012,KS,Nuclear,0,16569848,16569848
2012,KS,Other Biomass,114694,0,114694
2012,KS,Petroleum,68742,0,68742
2012,KS,Total,0,88849382,88849382
2012,KS,Wind,0,10390612,10390612
2012,KY,Coal,165523336,0,165523336
2012,KY,Hydroelectric Conventional,0,4723564,4723564
2012,KY,Natural Gas,5897324,0,5897324
2012,KY,Other,16150,0,16150
2012,KY,Other Biomass,192672,0,192672
2012,KY,Petroleum,3073242,0,3073242
2012,KY,Total,0,179899378,179899378
2012,KY,Wood and Wood Derived Fuels,473086,0,473086
2012,LA,Coal,42843738,0,42843738
2012,LA,Hydroelectric Conventional,0,1359888,1359888
2012,LA,Natural Gas,117127512,0,117127512
2012,LA,Nuclear,0,31318264,31318264
2012,LA,Other,751428,0,751428
2012,LA,Other Biomass,127523,0,127523
2012,LA,Other Gases,2494802,0,2494802
2012,LA,Petroleum,6059696,0,6059696
2012,LA,Total,0,206815411,206815411
2012,LA,Wood and Wood Derived Fuels,4732562,0,4732562
2012,MA,Coal,4273844,0,4273844
2012,MA,Hydroelectric Conventional,0,1824964,1824964
2012,MA,Natural Gas,49344761,0,49344761
2012,MA,Nuclear,0,11719080,11719080
2012,MA,Other,1754618,0,1754618
2012,MA,Other Biomass,2112408,0,2112408
2012,MA,Petroleum,300796,0,300796
2012,MA,Pumped Storage,0,-615090,-615090
2012,MA,Solar Thermal and Photovoltaic,0,59228,59228
2012,MA,Total,0,71156843,71156843
2012,MA,Wind,0,179346,179346
2012,MA,Wood and Wood Derived Fuels,202888,0,202888
2012,MD,Coal,32369546,0,32369546
2012,MD,Hydroelectric Conventional,0,3313078,3313078
2012,MD,Natural Gas,9889790,0,9889790
2012,MD,Nuclear,0,27158532,27158532
2012,MD,Other,592997,0,592997
2012,MD,Other Biomass,790079,0,790079
2012,MD,Other Gases,224628,0,224628
2012,MD,Petroleum,274611,0,274611
2012,MD,Solar Thermal and Photovoltaic,0,44946,44946
2012,MD,Total,0,75619488,75619488
2012,MD,Wind,0,643374,643374
2012,MD,Wood and Wood Derived Fuels,317906,0,317906
2012,ME,Coal,90516,0,90516
2012,ME,Hydroelectric Conventional,0,7465208,7465208
2012,ME,Natural Gas,12087391,0,12087391
2012,ME,Other,907196,0,907196
2012,ME,Other Biomass,551728,0,551728
2012,ME,Petroleum,215723,0,215723
2012,ME,Total,0,30096592,30096592
2012,ME,Wind,0,1773836,1773836
2012,ME,Wood and Wood Derived Fuels,7004994,0,7004994
2012,MI,Coal,106272864,0,106272864
2012,MI,Hydroelectric Conventional,0,2413652,2413652
2012,MI,Natural Gas,43496716,0,43496716
2012,MI,Nuclear,0,56039428,56039428
2012,MI,Other,789326,0,789326
2012,MI,Other Biomass,1912453,0,1912453
2012,MI,Other Gases,629510,0,629510
2012,MI,Petroleum,650286,0,650286
2012,MI,Pumped Storage,0,-1546560,-1546560
2012,MI,Total,0,216316100,216316100
2012,MI,Wind,0,2263376,2263376
2012,MI,Wood and Wood Derived Fuels,3395048,0,3395048
2012,MN,Coal,45445549,0,45445549
2012,MN,Hydroelectric Conventional,0,1122044,1122044
2012,MN,Natural Gas,14176410,0,14176410
2012,MN,Nuclear,0,23887580,23887580
2012,MN,Other,788739,0,788739
2012,MN,Other Biomass,1998433,0,1998433
2012,MN,Petroleum,59187,0,59187
2012,MN,Solar Thermal and Photovoltaic,0,0,0
2012,MN,Total,0,105508866,105508866
2012,MN,Wind,0,16352434,16352434
2012,MN,Wood and Wood Derived Fuels,1678491,0,1678491
2012,MO,Coal,145550017,0,145550017
2012,MO,Hydroelectric Conventional,0,1428538,1428538
2012,MO,Natural Gas,12334328,0,12334328
2012,MO,Nuclear,0,21436658,21436658
2012,MO,Other,39528,0,39528
2012,MO,Other Biomass,107602,0,107602
2012,MO,Petroleum,155526,0,155526
2012,MO,Pumped Storage,0,66888,66888
2012,MO,Total,0,183608642,183608642
2012,MO,Wind,0,2489556,2489556
2012,MO,Wood and Wood Derived Fuels,0,0,0
2012,MS,Coal,14423946,0,14423946
2012,MS,Natural Gas,77099786,0,77099786
2012,MS,Nuclear,0,14592268,14592268
2012,MS,Other,46,0,46
2012,MS,Other Biomass,32882,0,32882
2012,MS,Petroleum,34164,0,34164
2012,MS,Total,0,109168590,109168590
2012,MS,Wood and Wood Derived Fuels,2985497,0,2985497
2012,MT,Coal,27974783,0,27974783
2012,MT,Hydroelectric Conventional,0,22566930,22566930
2012,MT,Natural Gas,927996,0,927996
2012,MT,Other,682380,0,682380
2012,MT,Other Gases,28,0,28
2012,MT,Petroleum,933945,0,933945
2012,MT,Total,0,55609564,55609564
2012,MT,Wind,0,2523502,2523502
2012,NC,Coal,101864359,0,101864359
2012,NC,Hydroelectric Conventional,0,7455876,7455876
2012,NC,Natural Gas,38604016,0,38604016
2012,NC,Nuclear,0,78771184,78771184
2012,NC,Other,903730,0,903730
2012,NC,Other Biomass,604684,0,604684
2012,NC,Petroleum,356522,0,356522
2012,NC,Pumped Storage,0,0,0
2012,NC,Solar Thermal and Photovoltaic,0,278982,278982
2012,NC,Total,0,233363526,233363526
2012,NC,Wood and Wood Derived Fuels,4524174,0,4524174
2012,ND,Coal,56428728,0,56428728
2012,ND,Hydroelectric Conventional,0,4954460,4954460
2012,ND,Natural Gas,43393,0,43393
2012,ND,Other,127542,0,127542
2012,ND,Other Biomass,11086,0,11086
2012,ND,Other Gases,69780,0,69780
2012,ND,Petroleum,66308,0,66308
2012,ND,Total,0,72250318,72250318
2012,ND,Wind,0,10549018,10549018
2012,NE,Coal,50038432,0,50038432
2012,NE,Hydroelectric Conventional,0,2514108,2514108
2012,NE,Natural Gas,1540200,0,1540200
2012,NE,Nuclear,0,11603156,11603156
2012,NE,Other Biomass,126264,0,126264
2012,NE,Petroleum,45166,0,45166
2012,NE,Total,0,68434584,68434584
2012,NE,Wind,0,2567258,2567258
2012,NH,Coal,2535434,0,2535434
2012,NH,Hydroelectric Conventional,0,2494540,2494540
2012,NH,Natural Gas,14099407,0,14099407
2012,NH,Nuclear,0,16378362,16378362
2012,NH,Other,131024,0,131024
2012,NH,Other Biomass,274583,0,274583
2012,NH,Petroleum,43300,0,43300
2012,NH,Total,0,38444638,38444638
2012,NH,Wind,0,417398,417398
2012,NH,Wood and Wood Derived Fuels,2070590,0,2070590
2012,NJ,Coal,3794950,0,3794950
2012,NJ,Hydroelectric Conventional,0,21510,21510
2012,NJ,Natural Gas,56569809,0,56569809
2012,NJ,Nuclear,0,66220448,66220448
2012,NJ,Other,1265102,0,1265102
2012,NJ,Other Biomass,1929642,0,1929642
2012,NJ,Other Gases,284362,0,284362
2012,NJ,Petroleum,141559,0,141559
2012,NJ,Pumped Storage,0,-332352,-332352
2012,NJ,Solar Thermal and Photovoltaic,0,608652,608652
2012,NJ,Total,0,130526817,130526817
2012,NJ,Wind,0,23136,23136
2012,NM,Coal,49988098,0,49988098
2012,NM,Hydroelectric Conventional,0,445638,445638
2012,NM,Natural Gas,17598082,0,17598082
2012,NM,Other,0,0,0
2012,NM,Other Biomass,28532,0,28532
2012,NM,Petroleum,92298,0,92298
2012,NM,Solar Thermal and Photovoltaic,0,667594,667594
2012,NM,Total,0,73271818,73271818
2012,NM,Wind,0,4451576,4451576
2012,NV,Coal,8158863,0,8158863
2012,NV,Geothermal,4694930,0,4694930
2012,NV,Hydroelectric Conventional,0,4880830,4880830
2012,NV,Natural Gas,51293316,0,51293316
2012,NV,Other,23858,0,23858
2012,NV,Other Biomass,37922,0,37922
2012,NV,Other Gases,14648,0,14648
2012,NV,Petroleum,37750,0,37750
2012,NV,Solar Thermal and Photovoltaic,0,946834,946834
2012,NV,Total,0,70346526,70346526
2012,NV,Wind,0,257576,257576
2012,NV,Wood and Wood Derived Fuels,0,0,0
2012,NY,Coal,9102078,0,9102078
2012,NY,Hydroelectric Conventional,0,49304982,49304982
2012,NY,Natural Gas,118924513,0,118924513
2012,NY,Nuclear,0,81549120,81549120
2012,NY,Other,1936267,0,1936267
2012,NY,Other Biomass,3320702,0,3320702
2012,NY,Petroleum,1160569,0,1160569
2012,NY,Pumped Storage,0,-825890,-825890
2012,NY,Solar Thermal and Photovoltaic,0,105426,105426
2012,NY,Total,0,271536488,271536488
2012,NY,Wind,0,5983154,5983154
2012,NY,Wood and Wood Derived Fuels,975567,0,975567
2012,OH,Coal,171177273,0,171177273
2012,OH,Hydroelectric Conventional,0,828322,828322
2012,OH,Natural Gas,45330770,0,45330770
2012,OH,Nuclear,0,34173996,34173996
2012,OH,Other,23856,0,23856
2012,OH,Other Biomass,731226,0,731226
2012,OH,Other Gases,1917738,0,1917738
2012,OH,Petroleum,2562264,0,2562264
2012,OH,Solar Thermal and Photovoltaic,0,73274,73274
2012,OH,Total,0,259491462,259491462
2012,OH,Wind,0,1970970,1970970
2012,OH,Wood and Wood Derived Fuels,701776,0,701776
2012,OK,Coal,58603516,0,58603516
2012,OK,Hydroelectric Conventional,0,2291028,2291028
2012,OK,Natural Gas,78048600,0,78048600
2012,OK,Other,20116,0,20116
2012,OK,Other Biomass,188244,0,188244
2012,OK,Petroleum,21888,0,21888
2012,OK,Pumped Storage,0,-233420,-233420
2012,OK,Total,0,155793176,155793176
2012,OK,Wind,0,16315170,16315170
2012,OK,Wood and Wood Derived Fuels,538032,0,538032
2012,OR,Coal,5268670,0,5268670
2012,OR,Geothermal,51302,0,51302
2012,OR,Hydroelectric Conventional,0,78820356,78820356
2012,OR,Natural Gas,23249377,0,23249377
2012,OR,Other,100718,0,100718
2012,OR,Other Biomass,463174,0,463174
2012,OR,Petroleum,11850,0,11850
2012,OR,Solar Thermal and Photovoltaic,0,12824,12824
2012,OR,Total,0,121865460,121865460
2012,OR,Wind,0,12686968,12686968
2012,OR,Wood and Wood Derived Fuels,1200224,0,1200224
2012,PA,Coal,174296410,0,174296410
2012,PA,Hydroelectric Conventional,0,4483840,4483840
2012,PA,Natural Gas,106124397,0,106124397
2012,PA,Nuclear,0,150348816,150348816
2012,PA,Other,1791743,0,1791743
2012,PA,Other Biomass,3529456,0,3529456
2012,PA,Other Gases,1195936,0,1195936
2012,PA,Petroleum,566785,0,566785
2012,PA,Pumped Storage,0,-886734,-886734
2012,PA,Solar Thermal and Photovoltaic,0,64294,64294
2012,PA,Total,0,446839431,446839431
2012,PA,Wind,0,4257316,4257316
2012,PA,Wood and Wood Derived Fuels,1067170,0,1067170
2012,RI,Hydroelectric Conventional,0,8532,8532
2012,RI,Natural Gas,16370002,0,16370002
2012,RI,Other Biomass,201030,0,201030
2012,RI,Petroleum,35748,0,35748
2012,RI,Total,0,16618072,16618072
2012,RI,Wind,0,2760,2760
2012,SC,Coal,56792289,0,56792289
2012,SC,Hydroelectric Conventional,0,2840544,2840544
2012,SC,Natural Gas,28663759,0,28663759
2012,SC,Nuclear,0,102290604,102290604
2012,SC,Other,212492,0,212492
2012,SC,Other Biomass,405040,0,405040
2012,SC,Petroleum,216798,0,216798
2012,SC,Pumped Storage,0,-1792066,-1792066
2012,SC,Total,0,193511364,193511364
2012,SC,Wood and Wood Derived Fuels,3881906,0,3881906
2012,SD,Coal,5837512,0,5837512
2012,SD,Hydroelectric Conventional,0,11961930,11961930
2012,SD,Natural Gas,428202,0,428202
2012,SD,Other,0,0,0
2012,SD,Other Biomass,0,0,0
2012,SD,Petroleum,11436,0,11436
2012,SD,Total,0,22946794,22946794
2012,SD,Wind,0,4707714,4707714
2012,TN,Coal,70838619,0,70838619
2012,TN,Hydroelectric Conventional,0,16591320,16591320
2012,TN,Natural Gas,16150319,0,16150319
2012,TN,Nuclear,0,50204202,50204202
2012,TN,Other,1100,0,1100
2012,TN,Other Biomass,124412,0,124412
2012,TN,Other Gases,26972,0,26972
2012,TN,Petroleum,288960,0,288960
2012,TN,Pumped Storage,0,-325878,-325878
2012,TN,Solar Thermal and Photovoltaic,0,24366,24366
2012,TN,Total,0,155448527,155448527
2012,TN,Wind,0,94984,94984
2012,TN,Wood and Wood Derived Fuels,1429154,0,1429154
2012,TX,Coal,276176447,0,276176447
2012,TX,Hydroelectric Conventional,0,1168948,1168948
2012,TX,Natural Gas,427802565,0,427802565
2012,TX,Nuclear,0,76882034,76882034
2012,TX,Other,595594,0,595594
2012,TX,Other Biomass,1400550,0,1400550
2012,TX,Other Gases,5997632,0,5997632
2012,TX,Petroleum,2968408,0,2968408
2012,TX,Solar Thermal and Photovoltaic,0,236530,236530
2012,TX,Total,0,859625020,859625020
2012,TX,Wind,0,64428346,64428346
2012,TX,Wood and Wood Derived Fuels,1967968,0,1967968
2012,UT,Coal,61598241,0,61598241
2012,UT,Geothermal,669276,0,669276
2012,UT,Hydroelectric Conventional,0,1495572,1495572
2012,UT,Natural Gas,13159208,0,13159208
2012,UT,Other,266016,0,266016
2012,UT,Other Biomass,119112,0,119112
2012,UT,Other Gases,7862,0,7862
2012,UT,Petroleum,79573,0,79573
2012,UT,Solar Thermal and Photovoltaic,0,3238,3238
2012,UT,Total,0,78805921,78805921
2012,UT,Wind,0,1407822,1407822
2012,VA,Coal,28361591,0,28361591
2012,VA,Hydroelectric Conventional,0,2087548,2087548
2012,VA,Natural Gas,50075498,0,50075498
2012,VA,Nuclear,0,57446780,57446780
2012,VA,Other,793378,0,793378
2012,VA,Other Biomass,1845308,0,1845308
2012,VA,Petroleum,727935,0,727935
2012,VA,Pumped Storage,0,-2731148,-2731148
2012,VA,Total,0,141478470,141478470
2012,VA,Wood and Wood Derived Fuels,2871579,0,2871579
2012,VT,Hydroelectric Conventional,0,2302642,2302642
2012,VT,Natural Gas,5078,0,5078
2012,VT,Nuclear,0,9978676,9978676
2012,VT,Other Biomass,51292,0,51292
2012,VT,Petroleum,6840,0,6840
2012,VT,Solar Thermal and Photovoltaic,0,10128,10128
2012,VT,Total,0,13223572,13223572
2012,VT,Wind,0,213794,213794
2012,VT,Wood and Wood Derived Fuels,655122,0,655122
2012,WA,Coal,7525914,0,7525914
2012,WA,Hydroelectric Conventional,0,178928710,178928710
2012,WA,Natural Gas,10875186,0,10875186
2012,WA,Nuclear,0,18667418,18667418
2012,WA,Other,293820,0,293820
2012,WA,Other Biomass,477978,0,477978
2012,WA,Other Gases,810674,0,810674
2012,WA,Petroleum,53426,0,53426
2012,WA,Pumped Storage,0,87102,87102
2012,WA,Solar Thermal and Photovoltaic,0,1588,1588
2012,WA,Total,0,233670946,233670946
2012,WA,Wind,0,13199532,13199532
2012,WA,Wood and Wood Derived Fuels,2749602,0,2749602
2012,WI,Coal,65516870,0,65516870
2012,WI,Hydroelectric Conventional,0,3060526,3060526
2012,WI,Natural Gas,23084014,0,23084014
2012,WI,Nuclear,0,28599190,28599190
2012,WI,Other,159785,0,159785
2012,WI,Other Biomass,1033451,0,1033451
2012,WI,Petroleum,635136,0,635136
2012,WI,Total,0,127501876,127501876
2012,WI,Wind,0,3115156,3115156
2012,WI,Wood and Wood Derived Fuels,2297747,0,2297747
2012,WV,Coal,140534858,0,140534858
2012,WV,Hydroelectric Conventional,0,2862880,2862880
2012,WV,Natural Gas,485788,0,485788
2012,WV,Other,0,0,0
2012,WV,Other Biomass,21080,0,21080
2012,WV,Other Gases,63262,0,63262
2012,WV,Petroleum,286896,0,286896
2012,WV,Total,0,146826810,146826810
2012,WV,Wind,0,2572048,2572048
2012,WV,Wood and Wood Derived Fuels,-2,0,-2
2012,WY,Coal,86823531,0,86823531
2012,WY,Hydroelectric Conventional,0,1786940,1786940
2012,WY,Natural Gas,1025830,0,1025830
2012,WY,Other,133992,0,133992
2012,WY,Other Gases,564998,0,564998
2012,WY,Petroleum,103707,0,103707
2012,WY,Total,0,99177212,99177212
2012,WY,Wind,0,8738214,8738214
2013,AK,Coal,1249241.43,0,1249241.43
2013,AK,Hydroelectric Conventional,0,2870958.86,2870958.86
2013,AK,Natural Gas,6842010.84,0,6842010.84
2013,AK,Other,-514,0,-514
2013,AK,Other Biomass,104063.94,0,104063.94
2013,AK,Petroleum,1637304.22,0,1637304.22
2013,AK,Total,0,12993643.28,12993643.28
2013,AK,Wind,0,290578,290578
2013,AK,Wood and Wood Derived Fuels,0,0,0
2013,AL,Coal,94100967.86,0,94100967.86
2013,AL,Hydroelectric Conventional,0,25798356,25798356
2013,AL,Natural Gas,93172770.49,0,93172770.49
2013,AL,Nuclear,0,81632270,81632270
2013,AL,Other,6593.46,0,6593.46
2013,AL,Other Biomass,42380.26,0,42380.26
2013,AL,Other Gases,535471.1,0,535471.1
2013,AL,Petroleum,148261.95,0,148261.95
2013,AL,Total,0,301145847.7,301145847.7
2013,AL,Wood and Wood Derived Fuels,5708776.58,0,5708776.58
2013,AR,Coal,63778469.1,0,63778469.1
2013,AR,Hydroelectric Conventional,0,5309480.88,5309480.88
2013,AR,Natural Gas,24278754.15,0,24278754.15
2013,AR,Nuclear,0,23890514,23890514
2013,AR,Other,41129.9,0,41129.9
2013,AR,Other Biomass,210436.92,0,210436.92
2013,AR,Petroleum,83373.85,0,83373.85
2013,AR,Pumped Storage,0,61636,61636
2013,AR,Total,0,120644984.3,120644984.3
2013,AR,Wood and Wood Derived Fuels,2991189.48,0,2991189.48
2013,AZ,Coal,86984751.62,0,86984751.62
2013,AZ,Hydroelectric Conventional,0,11829316,11829316
2013,AZ,Natural Gas,59369262.59,0,59369262.59
2013,AZ,Nuclear,0,62862160,62862160
2013,AZ,Other,6722.96,0,6722.96
2013,AZ,Other Biomass,138267.12,0,138267.12
2013,AZ,Petroleum,85929.54,0,85929.54
2013,AZ,Pumped Storage,0,48542,48542
2013,AZ,Solar Thermal and Photovoltaic,0,4222877.28,4222877.28
2013,AZ,Total,0,226651972.2,226651972.2
2013,AZ,Wind,0,899528,899528
2013,AZ,Wood and Wood Derived Fuels,204615.14,0,204615.14
2013,CA,Coal,1646341.91,0,1646341.91
2013,CA,Geothermal,24613142,0,24613142
2013,CA,Hydroelectric Conventional,0,47509198.96,47509198.96
2013,CA,Natural Gas,239045718.6,0,239045718.6
2013,CA,Nuclear,0,35823886,35823886
2013,CA,Other,1632089.5,0,1632089.5
2013,CA,Other Biomass,5686405.69,0,5686405.69
2013,CA,Other Gases,2811440.36,0,2811440.36
2013,CA,Petroleum,137709.51,0,137709.51
2013,CA,Pumped Storage,0,392580,392580
2013,CA,Solar Thermal and Photovoltaic,0,7627449.58,7627449.58
2013,CA,Total,0,400154229.2,400154229.2
2013,CA,Wind,0,25644120.86,25644120.86
2013,CA,Wood and Wood Derived Fuels,7584146.32,0,7584146.32
2013,CO,Coal,67406873.64,0,67406873.64
2013,CO,Hydroelectric Conventional,0,2425744,2425744
2013,CO,Natural Gas,21417609,0,21417609
2013,CO,Other,92360,0,92360
2013,CO,Other Biomass,162242.5,0,162242.5
2013,CO,Petroleum,20384.68,0,20384.68
2013,CO,Pumped Storage,0,-560866,-560866
2013,CO,Solar Thermal and Photovoltaic,0,496904.92,496904.92
2013,CO,Total,0,105874871.8,105874871.8
2013,CO,Wind,0,14407440.38,14407440.38
2013,CO,Wood and Wood Derived Fuels,6178.7,0,6178.7
2013,CT,Coal,1361305.06,0,1361305.06
2013,CT,Hydroelectric Conventional,0,803856.1,803856.1
2013,CT,Natural Gas,31560594.08,0,31560594.08
2013,CT,Nuclear,0,34159164,34159164
2013,CT,Other,1422477.82,0,1422477.82
2013,CT,Other Biomass,1295602.39,0,1295602.39
2013,CT,Petroleum,612104.15,0,612104.15
2013,CT,Pumped Storage,0,-2102,-2102
2013,CT,Solar Thermal and Photovoltaic,0,0,0
2013,CT,Total,0,71221578.64,71221578.64
2013,CT,Wood and Wood Derived Fuels,8577.08,0,8577.08
2013,DC,Natural Gas,131704.16,0,131704.16
2013,DC,Petroleum,0,0,0
2013,DC,Total,0,131704.16,131704.16
2013,DE,Coal,3089441.02,0,3089441.02
2013,DE,Natural Gas,11862575.72,0,11862575.72
2013,DE,Other Biomass,114694,0,114694
2013,DE,Other Gases,310817.18,0,310817.18
2013,DE,Petroleum,45824.08,0,45824.08
2013,DE,Solar Thermal and Photovoltaic,0,89454,89454
2013,DE,Total,0,15521722,15521722
2013,DE,Wind,0,8916,8916
2013,FL,Coal,92685109.42,0,92685109.42
2013,FL,Hydroelectric Conventional,0,508428,508428
2013,FL,Natural Gas,277932737.1,0,277932737.1
2013,FL,Nuclear,0,53051710,53051710
2013,FL,Other,6172097.02,0,6172097.02
2013,FL,Other Biomass,4618882.4,0,4618882.4
2013,FL,Other Gases,9342.86,0,9342.86
2013,FL,Petroleum,5120932.36,0,5120932.36
2013,FL,Solar Thermal and Photovoltaic,0,419804,419804
2013,FL,Total,0,444797848,444797848
2013,FL,Wood and Wood Derived Fuels,4278804.83,0,4278804.83
2013,GA,Coal,80465732.52,0,80465732.52
2013,GA,Hydroelectric Conventional,0,7427180.38,7427180.38
2013,GA,Natural Gas,80659694.69,0,80659694.69
2013,GA,Nuclear,0,65805562,65805562
2013,GA,Other,175669.22,0,175669.22
2013,GA,Other Biomass,830477.3,0,830477.3
2013,GA,Petroleum,549875.3,0,549875.3
2013,GA,Pumped Storage,0,-854602,-854602
2013,GA,Solar Thermal and Photovoltaic,0,28994.6,28994.6
2013,GA,Total,0,241907468.6,241907468.6
2013,GA,Wood and Wood Derived Fuels,6818884.6,0,6818884.6
2013,HI,Coal,2807507.74,0,2807507.74
2013,HI,Geothermal,549682,0,549682
2013,HI,Hydroelectric Conventional,0,156589.28,156589.28
2013,HI,Other,787854.22,0,787854.22
2013,HI,Other Biomass,658728.5,0,658728.5
2013,HI,Other Gases,82659.32,0,82659.32
2013,HI,Petroleum,14445531.58,0,14445531.58
2013,HI,Solar Thermal and Photovoltaic,0,38931.92,38931.92
2013,HI,Total,0,20534104.54,20534104.54
2013,HI,Wind,0,1006620,1006620
2013,IA,Coal,66604690.24,0,66604690.24
2013,IA,Hydroelectric Conventional,0,1498244,1498244
2013,IA,Natural Gas,2860023.41,0,2860023.41
2013,IA,Nuclear,0,10641570,10641570
2013,IA,Other,0,0,0
2013,IA,Other Biomass,317260.92,0,317260.92
2013,IA,Petroleum,282912.46,0,282912.46
2013,IA,Total,0,113341513.8,113341513.8
2013,IA,Wind,0,31136812.82,31136812.82
2013,IA,Wood and Wood Derived Fuels,0,0,0
2013,ID,Coal,183236.22,0,183236.22
2013,ID,Geothermal,79366,0,79366
2013,ID,Hydroelectric Conventional,0,16946901.52,16946901.52
2013,ID,Natural Gas,6783819.72,0,6783819.72
2013,ID,Other,154116,0,154116
2013,ID,Other Biomass,396830.28,0,396830.28
2013,ID,Petroleum,76,0,76
2013,ID,Total,0,30372256.42,30372256.42
2013,ID,Wind,0,4920262,4920262
2013,ID,Wood and Wood Derived Fuels,907648.68,0,907648.68
2013,IL,Coal,175854279,0,175854279
2013,IL,Hydroelectric Conventional,0,240590,240590
2013,IL,Natural Gas,13655371.73,0,13655371.73
2013,IL,Nuclear,0,194262872,194262872
2013,IL,Other,569289.62,0,569289.62
2013,IL,Other Biomass,1215972.9,0,1215972.9
2013,IL,Other Gases,711900.75,0,711900.75
2013,IL,Petroleum,144865.01,0,144865.01
2013,IL,Solar Thermal and Photovoltaic,0,104240,104240
2013,IL,Total,0,406009839,406009839
2013,IL,Wind,0,19250458,19250458
2013,IL,Wood and Wood Derived Fuels,0,0,0
2013,IN,Coal,185343884,0,185343884
2013,IN,Hydroelectric Conventional,0,773856,773856
2013,IN,Natural Gas,18064472.66,0,18064472.66
2013,IN,Other,884929,0,884929
2013,IN,Other Biomass,752605.52,0,752605.52
2013,IN,Other Gases,4819323.02,0,4819323.02
2013,IN,Petroleum,3144618.08,0,3144618.08
2013,IN,Solar Thermal and Photovoltaic,0,61080,61080
2013,IN,Total,0,220806954.2,220806954.2
2013,IN,Wind,0,6962186,6962186
2013,IN,Wood and Wood Derived Fuels,0,0,0
2013,KS,Coal,59534524.08,0,59534524.08
2013,KS,Hydroelectric Conventional,0,29036,29036
2013,KS,Natural Gas,3960357.03,0,3960357.03
2013,KS,Nuclear,0,14336602,14336602
2013,KS,Other,0,0,0
2013,KS,Other Biomass,116004.8,0,116004.8
2013,KS,Petroleum,102246.7,0,102246.7
2013,KS,Total,0,96945162.6,96945162.6
2013,KS,Wind,0,18866392,18866392
2013,KY,Coal,166606520.9,0,166606520.9
2013,KY,Hydroelectric Conventional,0,6550428,6550428
2013,KY,Natural Gas,2836692.3,0,2836692.3
2013,KY,Other,17169.4,0,17169.4
2013,KY,Other Biomass,196984.16,0,196984.16
2013,KY,Petroleum,2817870.34,0,2817870.34
2013,KY,Total,0,179482042.4,179482042.4
2013,KY,Wood and Wood Derived Fuels,456377.32,0,456377.32
2013,LA,Coal,41687425.04,0,41687425.04
2013,LA,Hydroelectric Conventional,0,2089122,2089122
2013,LA,Natural Gas,105020349.7,0,105020349.7
2013,LA,Nuclear,0,33908788,33908788
2013,LA,Other,1358507.02,0,1358507.02
2013,LA,Other Biomass,164693.56,0,164693.56
2013,LA,Other Gases,4492560.13,0,4492560.13
2013,LA,Petroleum,9890396.52,0,9890396.52
2013,LA,Total,0,204020354,204020354
2013,LA,Wood and Wood Derived Fuels,5408512,0,5408512
2013,MA,Coal,7918458.54,0,7918458.54
2013,MA,Hydroelectric Conventional,0,1983008.1,1983008.1
2013,MA,Natural Gas,42513774.23,0,42513774.23
2013,MA,Nuclear,0,8661286,8661286
2013,MA,Other,1751851.78,0,1751851.78
2013,MA,Other Biomass,2121081.21,0,2121081.21
2013,MA,Petroleum,780622.58,0,780622.58
2013,MA,Pumped Storage,0,-735812,-735812
2013,MA,Solar Thermal and Photovoltaic,0,212914.02,212914.02
2013,MA,Total,0,65770041.36,65770041.36
2013,MA,Wind,0,409795.12,409795.12
2013,MA,Wood and Wood Derived Fuels,153061.78,0,153061.78
2013,MD,Coal,31076938.07,0,31076938.07
2013,MD,Hydroelectric Conventional,0,3454040,3454040
2013,MD,Natural Gas,5775178.44,0,5775178.44
2013,MD,Nuclear,0,28528610,28528610
2013,MD,Other,605423.59,0,605423.59
2013,MD,Other Biomass,826440.14,0,826440.14
2013,MD,Petroleum,379106.43,0,379106.43
2013,MD,Solar Thermal and Photovoltaic,0,126970.78,126970.78
2013,MD,Total,0,71701624.66,71701624.66
2013,MD,Wind,0,643340,643340
2013,MD,Wood and Wood Derived Fuels,285577.21,0,285577.21
2013,ME,Coal,125503.55,0,125503.55
2013,ME,Hydroelectric Conventional,0,7120909.62,7120909.62
2013,ME,Natural Gas,9746776.32,0,9746776.32
2013,ME,Other,801902.89,0,801902.89
2013,ME,Other Biomass,440668.8,0,440668.8
2013,ME,Petroleum,478255.16,0,478255.16
2013,ME,Total,0,28060075.22,28060075.22
2013,ME,Wind,0,2095340.36,2095340.36
2013,ME,Wood and Wood Derived Fuels,7250718.53,0,7250718.53
2013,MI,Coal,112582905.7,0,112582905.7
2013,MI,Hydroelectric Conventional,0,2838098,2838098
2013,MI,Natural Gas,24682783.86,0,24682783.86
2013,MI,Nuclear,0,57841646,57841646
2013,MI,Other,624750.66,0,624750.66
2013,MI,Other Biomass,1975375.98,0,1975375.98
2013,MI,Other Gases,1913329.88,0,1913329.88
2013,MI,Petroleum,1064962.18,0,1064962.18
2013,MI,Pumped Storage,0,-1741644,-1741644
2013,MI,Total,0,210835601.1,210835601.1
2013,MI,Wind,0,5599248,5599248
2013,MI,Wood and Wood Derived Fuels,3454144.89,0,3454144.89
2013,MN,Coal,47035596.44,0,47035596.44
2013,MN,Hydroelectric Conventional,0,1022224.12,1022224.12
2013,MN,Natural Gas,12602106.33,0,12602106.33
2013,MN,Nuclear,0,21415434,21415434
2013,MN,Other,721705.87,0,721705.87
2013,MN,Other Biomass,1148491.05,0,1148491.05
2013,MN,Petroleum,54334.53,0,54334.53
2013,MN,Solar Thermal and Photovoltaic,0,5412,5412
2013,MN,Total,0,102593975.2,102593975.2
2013,MN,Wind,0,16517501.5,16517501.5
2013,MN,Wood and Wood Derived Fuels,2071169.38,0,2071169.38
2013,MO,Coal,152209635.3,0,152209635.3
2013,MO,Hydroelectric Conventional,0,2272854,2272854
2013,MO,Natural Gas,8799255.39,0,8799255.39
2013,MO,Nuclear,0,16734206,16734206
2013,MO,Other,32380.34,0,32380.34
2013,MO,Other Biomass,132672.14,0,132672.14
2013,MO,Petroleum,130950.72,0,130950.72
2013,MO,Pumped Storage,0,592150,592150
2013,MO,Total,0,183253185.9,183253185.9
2013,MO,Wind,0,2333724,2333724
2013,MO,Wood and Wood Derived Fuels,15357.94,0,15357.94
2013,MS,Coal,17402590.16,0,17402590.16
2013,MS,Natural Gas,63553777.02,0,63553777.02
2013,MS,Nuclear,0,21729018,21729018
2013,MS,Other,10404.12,0,10404.12
2013,MS,Other Biomass,30346.76,0,30346.76
2013,MS,Petroleum,27964.28,0,27964.28
2013,MS,Total,0,105620527.8,105620527.8
2013,MS,Wood and Wood Derived Fuels,2866427.46,0,2866427.46
2013,MT,Coal,29760590.98,0,29760590.98
2013,MT,Hydroelectric Conventional,0,19276519.56,19276519.56
2013,MT,Natural Gas,1228462.47,0,1228462.47
2013,MT,Other,664920,0,664920
2013,MT,Other Gases,32.12,0,32.12
2013,MT,Petroleum,924604.44,0,924604.44
2013,MT,Total,0,55374652.62,55374652.62
2013,MT,Wind,0,3509289.06,3509289.06
2013,MT,Wood and Wood Derived Fuels,10234,0,10234
2013,NC,Coal,94144419.18,0,94144419.18
2013,NC,Hydroelectric Conventional,0,13801065,13801065
2013,NC,Natural Gas,55965018.17,0,55965018.17
2013,NC,Nuclear,0,80483474,80483474
2013,NC,Other,1133768.21,0,1133768.21
2013,NC,Other Biomass,820588.39,0,820588.39
2013,NC,Petroleum,435141.72,0,435141.72
2013,NC,Pumped Storage,0,0,0
2013,NC,Solar Thermal and Photovoltaic,0,689325.62,689325.62
2013,NC,Total,0,251872586.7,251872586.7
2013,NC,Wood and Wood Derived Fuels,4399786.45,0,4399786.45
2013,ND,Coal,54955644.6,0,54955644.6
2013,ND,Hydroelectric Conventional,0,3704842,3704842
2013,ND,Natural Gas,108389.32,0,108389.32
2013,ND,Other,76106,0,76106
2013,ND,Other Biomass,10962,0,10962
2013,ND,Other Gases,83218.14,0,83218.14
2013,ND,Petroleum,66267.4,0,66267.4
2013,ND,Total,0,70043345.46,70043345.46
2013,ND,Wind,0,11037916,11037916
2013,NE,Coal,53534202.4,0,53534202.4
2013,NE,Hydroelectric Conventional,0,2247830,2247830
2013,NE,Natural Gas,873290.58,0,873290.58
2013,NE,Nuclear,0,13730734,13730734
2013,NE,Other,0,0,0
2013,NE,Other Biomass,134557.74,0,134557.74
2013,NE,Petroleum,85121.08,0,85121.08
2013,NE,Total,0,74209255.54,74209255.54
2013,NE,Wind,0,3603519.74,3603519.74
2013,NE,Wood and Wood Derived Fuels,0,0,0
2013,NH,Coal,2927062.5,0,2927062.5
2013,NH,Hydroelectric Conventional,0,2854396.84,2854396.84
2013,NH,Natural Gas,8200344.02,0,8200344.02
2013,NH,Nuclear,0,21853450,21853450
2013,NH,Other,121957.44,0,121957.44
2013,NH,Other Biomass,274572.92,0,274572.92
2013,NH,Petroleum,209024.22,0,209024.22
2013,NH,Total,0,39557040.9,39557040.9
2013,NH,Wind,0,778368,778368
2013,NH,Wood and Wood Derived Fuels,2337864.96,0,2337864.96
2013,NJ,Coal,4043236.76,0,4043236.76
2013,NJ,Hydroelectric Conventional,0,36548,36548
2013,NJ,Natural Gas,54153060.54,0,54153060.54
2013,NJ,Nuclear,0,66759376,66759376
2013,NJ,Other,1250167.08,0,1250167.08
2013,NJ,Other Biomass,1997664.36,0,1997664.36
2013,NJ,Other Gases,446328.04,0,446328.04
2013,NJ,Petroleum,323197.08,0,323197.08
2013,NJ,Pumped Storage,0,-404266,-404266
2013,NJ,Solar Thermal and Photovoltaic,0,874817.56,874817.56
2013,NJ,Total,0,129501883.4,129501883.4
2013,NJ,Wind,0,21754,21754
2013,NM,Coal,48290541.82,0,48290541.82
2013,NM,Geothermal,138,0,138
2013,NM,Hydroelectric Conventional,0,183676,183676
2013,NM,Natural Gas,17950486.2,0,17950486.2
2013,NM,Other,1432,0,1432
2013,NM,Other Biomass,37036.36,0,37036.36
2013,NM,Petroleum,115695.56,0,115695.56
2013,NM,Solar Thermal and Photovoltaic,0,776082.42,776082.42
2013,NM,Total,0,71741930.36,71741930.36
2013,NM,Wind,0,4386842,4386842
2013,NV,Coal,10509106.49,0,10509106.49
2013,NV,Geothermal,5339906.16,0,5339906.16
2013,NV,Hydroelectric Conventional,0,5363886,5363886
2013,NV,Natural Gas,49533266.36,0,49533266.36
2013,NV,Other,50777.26,0,50777.26
2013,NV,Other Biomass,48554,0,48554
2013,NV,Other Gases,12608.3,0,12608.3
2013,NV,Petroleum,37780.63,0,37780.63
2013,NV,Solar Thermal and Photovoltaic,0,1490764,1490764
2013,NV,Total,0,72887747.18,72887747.18
2013,NV,Wind,0,501098,501098
2013,NV,Wood and Wood Derived Fuels,0,0,0
2013,NY,Coal,9394209.48,0,9394209.48
2013,NY,Hydroelectric Conventional,0,49946578.56,49946578.56
2013,NY,Natural Gas,108708773.2,0,108708773.2
2013,NY,Nuclear,0,89511212,89511212
2013,NY,Other,1767654.92,0,1767654.92
2013,NY,Other Biomass,3348082.76,0,3348082.76
2013,NY,Petroleum,2014746.62,0,2014746.62
2013,NY,Pumped Storage,0,-885736,-885736
2013,NY,Solar Thermal and Photovoltaic,0,134034.32,134034.32
2013,NY,Total,0,272233659.9,272233659.9
2013,NY,Wind,0,7078996,7078996
2013,NY,Wood and Wood Derived Fuels,1215108.06,0,1215108.06
2013,OH,Coal,189127769.7,0,189127769.7
2013,OH,Hydroelectric Conventional,0,1098476,1098476
2013,OH,Natural Gas,43388422.7,0,43388422.7
2013,OH,Nuclear,0,32242500,32242500
2013,OH,Other,15247.3,0,15247.3
2013,OH,Other Biomass,948932.28,0,948932.28
2013,OH,Other Gases,1905667.36,0,1905667.36
2013,OH,Petroleum,2771775.88,0,2771775.88
2013,OH,Solar Thermal and Photovoltaic,0,92619.08,92619.08
2013,OH,Total,0,274568377.4,274568377.4
2013,OH,Wind,0,2291801.16,2291801.16
2013,OH,Wood and Wood Derived Fuels,685165.96,0,685165.96
2013,OK,Coal,59998897,0,59998897
2013,OK,Hydroelectric Conventional,0,4356156,4356156
2013,OK,Natural Gas,60111995.57,0,60111995.57
2013,OK,Other,3995.5,0,3995.5
2013,OK,Other Biomass,251195.36,0,251195.36
2013,OK,Petroleum,20422.13,0,20422.13
2013,OK,Pumped Storage,0,-156914,-156914
2013,OK,Total,0,147347360.5,147347360.5
2013,OK,Wind,0,22324986,22324986
2013,OK,Wood and Wood Derived Fuels,436626.96,0,436626.96
2013,OR,Coal,7517991.44,0,7517991.44
2013,OR,Geothermal,329298,0,329298
2013,OR,Hydroelectric Conventional,0,66195334,66195334
2013,OR,Natural Gas,28726080.54,0,28726080.54
2013,OR,Other,69491,0,69491
2013,OR,Other Biomass,587776.75,0,587776.75
2013,OR,Petroleum,12302.88,0,12302.88
2013,OR,Solar Thermal and Photovoltaic,0,40986,40986
2013,OR,Total,0,119791029.3,119791029.3
2013,OR,Wind,0,14911404,14911404
2013,OR,Wood and Wood Derived Fuels,1400364.7,0,1400364.7
2013,PA,Coal,176886417.9,0,176886417.9
2013,PA,Hydroelectric Conventional,0,5049346.04,5049346.04
2013,PA,Natural Gas,99875404.59,0,99875404.59
2013,PA,Nuclear,0,157428062,157428062
2013,PA,Other,1681158.22,0,1681158.22
2013,PA,Other Biomass,3693680.32,0,3693680.32
2013,PA,Other Gases,1300294.88,0,1300294.88
2013,PA,Petroleum,920144.06,0,920144.06
2013,PA,Pumped Storage,0,-1077540,-1077540
2013,PA,Solar Thermal and Photovoltaic,0,126211.62,126211.62
2013,PA,Total,0,453571260.9,453571260.9
2013,PA,Wind,0,6704086,6704086
2013,PA,Wood and Wood Derived Fuels,983995.3,0,983995.3
2013,RI,Hydroelectric Conventional,0,8894.16,8894.16
2013,RI,Natural Gas,12278180.84,0,12278180.84
2013,RI,Other Biomass,96264.76,0,96264.76
2013,RI,Petroleum,101080.48,0,101080.48
2013,RI,Solar Thermal and Photovoltaic,0,4013.2,4013.2
2013,RI,Total,0,12493613.44,12493613.44
2013,RI,Wind,0,5180,5180
2013,SC,Coal,48814295.56,0,48814295.56
2013,SC,Hydroelectric Conventional,0,6320548,6320548
2013,SC,Natural Gas,23668148.36,0,23668148.36
2013,SC,Nuclear,0,108503936,108503936
2013,SC,Other,124013.92,0,124013.92
2013,SC,Other Biomass,425792.56,0,425792.56
2013,SC,Petroleum,206692.46,0,206692.46
2013,SC,Pumped Storage,0,-1589844,-1589844
2013,SC,Solar Thermal and Photovoltaic,0,230,230
2013,SC,Total,0,190499787.9,190499787.9
2013,SC,Wood and Wood Derived Fuels,4025975.08,0,4025975.08
2013,SD,Coal,5698766.86,0,5698766.86
2013,SD,Hydroelectric Conventional,0,8125218,8125218
2013,SD,Natural Gas,1004401.98,0,1004401.98
2013,SD,Other,0,0,0
2013,SD,Other Biomass,0,0,0
2013,SD,Petroleum,13988.16,0,13988.16
2013,SD,Total,0,20217773,20217773
2013,SD,Wind,0,5375398,5375398
2013,TN,Coal,64971661.64,0,64971661.64
2013,TN,Hydroelectric Conventional,0,24886566,24886566
2013,TN,Natural Gas,10033396.52,0,10033396.52
2013,TN,Nuclear,0,56987628,56987628
2013,TN,Other,1102.14,0,1102.14
2013,TN,Other Biomass,170066.72,0,170066.72
2013,TN,Other Gases,25536.52,0,25536.52
2013,TN,Petroleum,260993.37,0,260993.37
2013,TN,Pumped Storage,0,-84024,-84024
2013,TN,Solar Thermal and Photovoltaic,0,40788,40788
2013,TN,Total,0,159303238.9,159303238.9
2013,TN,Wind,0,93490,93490
2013,TN,Wood and Wood Derived Fuels,1916033.96,0,1916033.96
2013,TX,Coal,298808486.6,0,298808486.6
2013,TX,Hydroelectric Conventional,0,960084,960084
2013,TX,Natural Gas,407596831.1,0,407596831.1
2013,TX,Nuclear,0,76629992,76629992
2013,TX,Other,544281.2,0,544281.2
2013,TX,Other Biomass,1460459.14,0,1460459.14
2013,TX,Other Gases,4799938.54,0,4799938.54
2013,TX,Petroleum,1901603.06,0,1901603.06
2013,TX,Solar Thermal and Photovoltaic,0,326025.86,326025.86
2013,TX,Total,0,866760331.4,866760331.4
2013,TX,Wind,0,71747241.88,71747241.88
2013,TX,Wood and Wood Derived Fuels,1985387.96,0,1985387.96
2013,UT,Coal,68569913.63,0,68569913.63
2013,UT,Geothermal,637816,0,637816
2013,UT,Hydroelectric Conventional,0,1009992,1009992
2013,UT,Natural Gas,13212845.76,0,13212845.76
2013,UT,Other,321727.18,0,321727.18
2013,UT,Other Biomass,141852.48,0,141852.48
2013,UT,Other Gases,3540.56,0,3540.56
2013,UT,Petroleum,52002.06,0,52002.06
2013,UT,Solar Thermal and Photovoltaic,0,4200,4200
2013,UT,Total,0,85033501.64,85033501.64
2013,UT,Wind,0,1079612,1079612
2013,VA,Coal,42321002.53,0,42321002.53
2013,VA,Hydroelectric Conventional,0,2507339.04,2507339.04
2013,VA,Natural Gas,45302333.96,0,45302333.96
2013,VA,Nuclear,0,58652462,58652462
2013,VA,Other,949533.44,0,949533.44
2013,VA,Other Biomass,1919449.58,0,1919449.58
2013,VA,Petroleum,626576.14,0,626576.14
2013,VA,Pumped Storage,0,-2378000,-2378000
2013,VA,Total,0,153793130.1,153793130.1
2013,VA,Wood and Wood Derived Fuels,3892433.44,0,3892433.44
2013,VT,Hydroelectric Conventional,0,2571824,2571824
2013,VT,Natural Gas,6058.26,0,6058.26
2013,VT,Nuclear,0,9692654,9692654
2013,VT,Other Biomass,51396,0,51396
2013,VT,Petroleum,10206.92,0,10206.92
2013,VT,Solar Thermal and Photovoltaic,0,34586,34586
2013,VT,Total,0,13769820,13769820
2013,VT,Wind,0,472068,472068
2013,VT,Wood and Wood Derived Fuels,931026.82,0,931026.82
2013,WA,Coal,13480849.96,0,13480849.96
2013,WA,Hydroelectric Conventional,0,156310174,156310174
2013,WA,Natural Gas,22848620.89,0,22848620.89
2013,WA,Nuclear,0,16921780,16921780
2013,WA,Other,258205.36,0,258205.36
2013,WA,Other Biomass,567807.06,0,567807.06
2013,WA,Other Gases,819571.46,0,819571.46
2013,WA,Petroleum,48725.08,0,48725.08
2013,WA,Pumped Storage,0,14376,14376
2013,WA,Solar Thermal and Photovoltaic,0,1524,1524
2013,WA,Total,0,228345832.5,228345832.5
2013,WA,Wind,0,14008730,14008730
2013,WA,Wood and Wood Derived Fuels,3065468.68,0,3065468.68
2013,WI,Coal,81290361.85,0,81290361.85
2013,WI,Hydroelectric Conventional,0,3957744.12,3957744.12
2013,WI,Natural Gas,16204982.17,0,16204982.17
2013,WI,Nuclear,0,23350388,23350388
2013,WI,Other,132034.71,0,132034.71
2013,WI,Other Biomass,968680.43,0,968680.43
2013,WI,Petroleum,606110.56,0,606110.56
2013,WI,Total,0,131925583.6,131925583.6
2013,WI,Wind,0,3115848,3115848
2013,WI,Wood and Wood Derived Fuels,2299433.75,0,2299433.75
2013,WV,Coal,144568716.9,0,144568716.9
2013,WV,Hydroelectric Conventional,0,3477552,3477552
2013,WV,Natural Gas,539278.76,0,539278.76
2013,WV,Other,0,0,0
2013,WV,Other Biomass,7998,0,7998
2013,WV,Other Gases,59894.3,0,59894.3
2013,WV,Petroleum,299661.33,0,299661.33
2013,WV,Total,0,151726133.3,151726133.3
2013,WV,Wind,0,2773032,2773032
2013,WY,Coal,92873357.28,0,92873357.28
2013,WY,Hydroelectric Conventional,0,1421756.34,1421756.34
2013,WY,Natural Gas,1024877.3,0,1024877.3
2013,WY,Other,138560.38,0,138560.38
2013,WY,Other Gases,562399.52,0,562399.52
2013,WY,Petroleum,78612,0,78612
2013,WY,Total,0,104966130.8,104966130.8
2013,WY,Wind,0,8866568,8866568
2014,AK,Coal,1116584.36,0,1116584.36
2014,AK,Hydroelectric Conventional,0,3077476,3077476
2014,AK,Natural Gas,6576044.64,0,6576044.64
2014,AK,Other,-4626,0,-4626
2014,AK,Other Biomass,125023.36,0,125023.36
2014,AK,Petroleum,891242.9,0,891242.9
2014,AK,Total,0,12085659.26,12085659.26
2014,AK,Wind,0,303914,303914
2014,AK,Wood and Wood Derived Fuels,0,0,0
2014,AL,Coal,94603252.5,0,94603252.5
2014,AL,Hydroelectric Conventional,0,18933744,18933744
2014,AL,Natural Gas,96540148.76,0,96540148.76
2014,AL,Nuclear,0,82487378,82487378
2014,AL,Other,1321.94,0,1321.94
2014,AL,Other Biomass,93873.62,0,93873.62
2014,AL,Other Gases,360806.94,0,360806.94
2014,AL,Petroleum,196199.97,0,196199.97
2014,AL,Total,0,298680894.2,298680894.2
2014,AL,Wood and Wood Derived Fuels,5464168.44,0,5464168.44
2014,AR,Coal,66441509.58,0,66441509.58
2014,AR,Hydroelectric Conventional,0,5279552,5279552
2014,AR,Natural Gas,19227416.07,0,19227416.07
2014,AR,Nuclear,0,28956518,28956518
2014,AR,Other,26156.82,0,26156.82
2014,AR,Other Biomass,204547.42,0,204547.42
2014,AR,Petroleum,58547.54,0,58547.54
2014,AR,Pumped Storage,0,134140,134140
2014,AR,Total,0,123184273.3,123184273.3
2014,AR,Wood and Wood Derived Fuels,2855885.9,0,2855885.9
2014,AZ,Coal,85330021.14,0,85330021.14
2014,AZ,Hydroelectric Conventional,0,12236522,12236522
2014,AZ,Natural Gas,54483757.35,0,54483757.35
2014,AZ,Nuclear,0,64641834,64641834
2014,AZ,Other,0,0,0
2014,AZ,Other Biomass,122106,0,122106
2014,AZ,Petroleum,113724.29,0,113724.29
2014,AZ,Pumped Storage,0,27784,27784
2014,AZ,Solar Thermal and Photovoltaic,0,6283015.71,6283015.71
2014,AZ,Total,0,224514374.9,224514374.9
2014,AZ,Wind,0,936230,936230
2014,AZ,Wood and Wood Derived Fuels,339380.42,0,339380.42
2014,CA,Coal,1609519.14,0,1609519.14
2014,CA,Geothermal,24203456,0,24203456
2014,CA,Hydroelectric Conventional,0,33062680.32,33062680.32
2014,CA,Natural Gas,240852871,0,240852871
2014,CA,Nuclear,0,33971956,33971956
2014,CA,Other,1695669.92,0,1695669.92
2014,CA,Other Biomass,5826584.36,0,5826584.36
2014,CA,Other Gases,2665902.06,0,2665902.06
2014,CA,Petroleum,132610.59,0,132610.59
2014,CA,Pumped Storage,0,-209480,-209480
2014,CA,Solar Thermal and Photovoltaic,0,19863629.72,19863629.72
2014,CA,Total,0,397615243.6,397615243.6
2014,CA,Wind,0,25984995.16,25984995.16
2014,CA,Wood and Wood Derived Fuels,7954849.33,0,7954849.33
2014,CO,Coal,65089697.78,0,65089697.78
2014,CO,Hydroelectric Conventional,0,3539601.84,3539601.84
2014,CO,Natural Gas,23907616.52,0,23907616.52
2014,CO,Other,93748,0,93748
2014,CO,Other Biomass,158147.38,0,158147.38
2014,CO,Petroleum,19864.08,0,19864.08
2014,CO,Pumped Storage,0,-450528,-450528
2014,CO,Solar Thermal and Photovoltaic,0,506130,506130
2014,CO,Total,0,107694771.8,107694771.8
2014,CO,Wind,0,14737228,14737228
2014,CO,Wood and Wood Derived Fuels,93266.24,0,93266.24
2014,CT,Coal,1649895.78,0,1649895.78
2014,CT,Hydroelectric Conventional,0,867920.38,867920.38
2014,CT,Natural Gas,29367809.72,0,29367809.72
2014,CT,Nuclear,0,31681238,31681238
2014,CT,Other,1209012.82,0,1209012.82
2014,CT,Other Biomass,1300203.29,0,1300203.29
2014,CT,Petroleum,1026828.06,0,1026828.06
2014,CT,Pumped Storage,0,13564,13564
2014,CT,Solar Thermal and Photovoltaic,0,23412.46,23412.46
2014,CT,Total,0,67353960.82,67353960.82
2014,CT,Wood and Wood Derived Fuels,214076.32,0,214076.32
2014,DC,Natural Gas,135224.32,0,135224.32
2014,DC,Petroleum,0,0,0
2014,DC,Total,0,135224.32,135224.32
2014,DE,Coal,1730768.48,0,1730768.48
2014,DE,Natural Gas,12594916.79,0,12594916.79
2014,DE,Other Biomass,152998.76,0,152998.76
2014,DE,Other Gases,452757.78,0,452757.78
2014,DE,Petroleum,366563.24,0,366563.24
2014,DE,Solar Thermal and Photovoltaic,0,99060,99060
2014,DE,Total,0,15407167.04,15407167.04
2014,DE,Wind,0,10102,10102
2014,FL,Coal,104107378.3,0,104107378.3
2014,FL,Hydroelectric Conventional,0,422776,422776
2014,FL,Natural Gas,280068139.2,0,280068139.2
2014,FL,Nuclear,0,55736540,55736540
2014,FL,Other,5781631.49,0,5781631.49
2014,FL,Other Biomass,4583631.7,0,4583631.7
2014,FL,Other Gases,13338.88,0,13338.88
2014,FL,Petroleum,3755854.1,0,3755854.1
2014,FL,Solar Thermal and Photovoltaic,0,483368.36,483368.36
2014,FL,Total,0,460031874.6,460031874.6
2014,FL,Wood and Wood Derived Fuels,5079216.62,0,5079216.62
2014,GA,Coal,90590226.64,0,90590226.64
2014,GA,Hydroelectric Conventional,0,6128694,6128694
2014,GA,Natural Gas,81921595.84,0,81921595.84
2014,GA,Nuclear,0,65140364,65140364
2014,GA,Other,133994.78,0,133994.78
2014,GA,Other Biomass,826992.86,0,826992.86
2014,GA,Petroleum,755620.2,0,755620.2
2014,GA,Pumped Storage,0,-1561266,-1561266
2014,GA,Solar Thermal and Photovoltaic,0,238453.32,238453.32
2014,GA,Total,0,251674447.1,251674447.1
2014,GA,Wood and Wood Derived Fuels,7499771.42,0,7499771.42
2014,HI,Coal,3022367.65,0,3022367.65
2014,HI,Geothermal,507682,0,507682
2014,HI,Hydroelectric Conventional,0,188166.18,188166.18
2014,HI,Other,810037.77,0,810037.77
2014,HI,Other Biomass,668060.16,0,668060.16
2014,HI,Other Gases,124407.92,0,124407.92
2014,HI,Petroleum,13851837.32,0,13851837.32
2014,HI,Solar Thermal and Photovoltaic,0,78523.5,78523.5
2014,HI,Total,0,20408316.5,20408316.5
2014,HI,Wind,0,1157234,1157234
2014,IA,Coal,67465530.71,0,67465530.71
2014,IA,Hydroelectric Conventional,0,1757210,1757210
2014,IA,Natural Gas,2745030.55,0,2745030.55
2014,IA,Nuclear,0,8304936,8304936
2014,IA,Other,0,0,0
2014,IA,Other Biomass,528939.46,0,528939.46
2014,IA,Petroleum,287857.83,0,287857.83
2014,IA,Total,0,113706564.9,113706564.9
2014,IA,Wind,0,32613509.06,32613509.06
2014,IA,Wood and Wood Derived Fuels,3551.32,0,3551.32
2014,ID,Coal,155342.54,0,155342.54
2014,ID,Geothermal,157598,0,157598
2014,ID,Hydroelectric Conventional,0,18004420.34,18004420.34
2014,ID,Natural Gas,5105075.44,0,5105075.44
2014,ID,Other,149756,0,149756
2014,ID,Other Biomass,350828.88,0,350828.88
2014,ID,Petroleum,2,0,2
2014,ID,Total,0,30368833.01,30368833.01
2014,ID,Wind,0,5611600,5611600
2014,ID,Wood and Wood Derived Fuels,834209.8,0,834209.8
2014,IL,Coal,174564780.8,0,174564780.8
2014,IL,Hydroelectric Conventional,0,264596,264596
2014,IL,Natural Gas,10930850.11,0,10930850.11
2014,IL,Nuclear,0,195715800,195715800
2014,IL,Other,563264.96,0,563264.96
2014,IL,Other Biomass,1132744.72,0,1132744.72
2014,IL,Other Gases,676185.52,0,676185.52
2014,IL,Petroleum,173512.1,0,173512.1
2014,IL,Solar Thermal and Photovoltaic,0,100233.8,100233.8
2014,IL,Total,0,404287756,404287756
2014,IL,Wind,0,20165788,20165788
2014,IL,Wood and Wood Derived Fuels,0,0,0
2014,IN,Coal,195097477,0,195097477
2014,IN,Hydroelectric Conventional,0,742306,742306
2014,IN,Natural Gas,19144692.88,0,19144692.88
2014,IN,Other,781367.26,0,781367.26
2014,IN,Other Biomass,781077.48,0,781077.48
2014,IN,Other Gases,4322437.36,0,4322437.36
2014,IN,Petroleum,2725088.35,0,2725088.35
2014,IN,Solar Thermal and Photovoltaic,0,204253.8,204253.8
2014,IN,Total,0,230790783.6,230790783.6
2014,IN,Wind,0,6992083.38,6992083.38
2014,IN,Wood and Wood Derived Fuels,0,0,0
2014,KS,Coal,57504564.4,0,57504564.4
2014,KS,Hydroelectric Conventional,0,32428,32428
2014,KS,Natural Gas,2905046.78,0,2905046.78
2014,KS,Nuclear,0,17116768,17116768
2014,KS,Other,1.94,0,1.94
2014,KS,Other Biomass,118433.38,0,118433.38
2014,KS,Petroleum,89761.72,0,89761.72
2014,KS,Total,0,99456726.22,99456726.22
2014,KS,Wind,0,21689722,21689722
2014,KY,Coal,167203922.3,0,167203922.3
2014,KY,Hydroelectric Conventional,0,6287134,6287134
2014,KY,Natural Gas,4999198.59,0,4999198.59
2014,KY,Other,99882.54,0,99882.54
2014,KY,Other Biomass,187068,0,187068
2014,KY,Petroleum,2306753.96,0,2306753.96
2014,KY,Total,0,181792870.1,181792870.1
2014,KY,Wood and Wood Derived Fuels,708910.74,0,708910.74
2014,LA,Coal,38442038,0,38442038
2014,LA,Hydroelectric Conventional,0,2180076,2180076
2014,LA,Natural Gas,112241128.8,0,112241128.8
2014,LA,Nuclear,0,34622660,34622660
2014,LA,Other,1066394.04,0,1066394.04
2014,LA,Other Biomass,187753.61,0,187753.61
2014,LA,Other Gases,3885150.18,0,3885150.18
2014,LA,Petroleum,10462147.97,0,10462147.97
2014,LA,Total,0,208458803.3,208458803.3
2014,LA,Wood and Wood Derived Fuels,5371454.72,0,5371454.72
2014,MA,Coal,5589778,0,5589778
2014,MA,Hydroelectric Conventional,0,1804154.14,1804154.14
2014,MA,Natural Gas,36995429.36,0,36995429.36
2014,MA,Nuclear,0,11538308,11538308
2014,MA,Other,1756259.84,0,1756259.84
2014,MA,Other Biomass,2146843.06,0,2146843.06
2014,MA,Petroleum,2009667.36,0,2009667.36
2014,MA,Pumped Storage,0,-916316,-916316
2014,MA,Solar Thermal and Photovoltaic,0,612642.78,612642.78
2014,MA,Total,0,62237182.64,62237182.64
2014,MA,Wind,0,449942.1,449942.1
2014,MA,Wood and Wood Derived Fuels,250474.02,0,250474.02
2014,MD,Coal,35206581.81,0,35206581.81
2014,MD,Hydroelectric Conventional,0,3231046,3231046
2014,MD,Natural Gas,5011780.59,0,5011780.59
2014,MD,Nuclear,0,28686668,28686668
2014,MD,Other,626568.32,0,626568.32
2014,MD,Other Biomass,833437.66,0,833437.66
2014,MD,Petroleum,926911.24,0,926911.24
2014,MD,Solar Thermal and Photovoltaic,0,196235.44,196235.44
2014,MD,Total,0,75667304.84,75667304.84
2014,MD,Wind,0,647224.68,647224.68
2014,MD,Wood and Wood Derived Fuels,300851.08,0,300851.08
2014,ME,Coal,158207.84,0,158207.84
2014,ME,Hydroelectric Conventional,0,7246497,7246497
2014,ME,Natural Gas,8688762.73,0,8688762.73
2014,ME,Other,810258.68,0,810258.68
2014,ME,Other Biomass,410772.02,0,410772.02
2014,ME,Petroleum,610264.01,0,610264.01
2014,ME,Total,0,26497419.78,26497419.78
2014,ME,Wind,0,2194658,2194658
2014,ME,Wood and Wood Derived Fuels,6377999.51,0,6377999.51
2014,MI,Coal,105799688.4,0,105799688.4
2014,MI,Hydroelectric Conventional,0,3200044,3200044
2014,MI,Natural Gas,25045673.98,0,25045673.98
2014,MI,Nuclear,0,62491696,62491696
2014,MI,Other,807601.31,0,807601.31
2014,MI,Other Biomass,2110211.04,0,2110211.04
2014,MI,Other Gases,2239692.34,0,2239692.34
2014,MI,Petroleum,2102660.28,0,2102660.28
2014,MI,Pumped Storage,0,-1401778,-1401778
2014,MI,Total,0,213633982,213633982
2014,MI,Wind,0,7736235.34,7736235.34
2014,MI,Wood and Wood Derived Fuels,3502257.39,0,3502257.39
2014,MN,Coal,55913358.44,0,55913358.44
2014,MN,Hydroelectric Conventional,0,1096976.36,1096976.36
2014,MN,Natural Gas,7739265.14,0,7739265.14
2014,MN,Nuclear,0,25414332,25414332
2014,MN,Other,793974.98,0,793974.98
2014,MN,Other Biomass,1228482.17,0,1228482.17
2014,MN,Petroleum,125072.97,0,125072.97
2014,MN,Solar Thermal and Photovoltaic,0,5306,5306
2014,MN,Total,0,113996659.9,113996659.9
2014,MN,Wind,0,19382038.22,19382038.22
2014,MN,Wood and Wood Derived Fuels,2297853.67,0,2297853.67
2014,MO,Coal,144818424.3,0,144818424.3
2014,MO,Hydroelectric Conventional,0,1394672,1394672
2014,MO,Natural Gas,8088588.76,0,8088588.76
2014,MO,Nuclear,0,18552712,18552712
2014,MO,Other,52629.6,0,52629.6
2014,MO,Other Biomass,166451.51,0,166451.51
2014,MO,Petroleum,213310.64,0,213310.64
2014,MO,Pumped Storage,0,37706,37706
2014,MO,Solar Thermal and Photovoltaic,0,17414,17414
2014,MO,Total,0,175668936.4,175668936.4
2014,MO,Wind,0,2262210,2262210
2014,MO,Wood and Wood Derived Fuels,64817.66,0,64817.66
2014,MS,Coal,21485131.71,0,21485131.71
2014,MS,Natural Gas,65211898.87,0,65211898.87
2014,MS,Nuclear,0,20504366,20504366
2014,MS,Other,8687.92,0,8687.92
2014,MS,Other Biomass,34690.53,0,34690.53
2014,MS,Petroleum,28201.71,0,28201.71
2014,MS,Total,0,110254183.3,110254183.3
2014,MS,Wood and Wood Derived Fuels,2981206.6,0,2981206.6
2014,MT,Coal,31158830.87,0,31158830.87
2014,MT,Hydroelectric Conventional,0,22965502,22965502
2014,MT,Natural Gas,1030907.74,0,1030907.74
2014,MT,Other,529628,0,529628
2014,MT,Other Gases,19.62,0,19.62
2014,MT,Petroleum,856737.77,0,856737.77
2014,MT,Total,0,60515232.16,60515232.16
2014,MT,Wind,0,3947588.16,3947588.16
2014,MT,Wood and Wood Derived Fuels,26018,0,26018
2014,NC,Coal,98476393.74,0,98476393.74
2014,NC,Hydroelectric Conventional,0,9512166.48,9512166.48
2014,NC,Natural Gas,57475216.22,0,57475216.22
2014,NC,Nuclear,0,81934040,81934040
2014,NC,Other,1262305.3,0,1262305.3
2014,NC,Other Biomass,1039862.51,0,1039862.51
2014,NC,Petroleum,919373.97,0,919373.97
2014,NC,Pumped Storage,0,156018,156018
2014,NC,Solar Thermal and Photovoltaic,0,1458260.96,1458260.96
2014,NC,Total,0,256287176.3,256287176.3
2014,NC,Wood and Wood Derived Fuels,4053539.1,0,4053539.1
2014,ND,Coal,54788136.34,0,54788136.34
2014,ND,Hydroelectric Conventional,0,5062720,5062720
2014,ND,Natural Gas,468630.28,0,468630.28
2014,ND,Other,62880,0,62880
2014,ND,Other Biomass,5304,0,5304
2014,ND,Other Gases,80286.48,0,80286.48
2014,ND,Petroleum,52234.24,0,52234.24
2014,ND,Total,0,72925015.34,72925015.34
2014,ND,Wind,0,12404824,12404824
2014,NE,Coal,49844349.84,0,49844349.84
2014,NE,Hydroelectric Conventional,0,2315562,2315562
2014,NE,Natural Gas,811424.98,0,811424.98
2014,NE,Nuclear,0,20203676,20203676
2014,NE,Other,0,0,0
2014,NE,Other Biomass,128370.06,0,128370.06
2014,NE,Petroleum,85320.18,0,85320.18
2014,NE,Total,0,78862581.48,78862581.48
2014,NE,Wind,0,5473878.44,5473878.44
2014,NE,Wood and Wood Derived Fuels,0,0,0
2014,NH,Coal,2621997.46,0,2621997.46
2014,NH,Hydroelectric Conventional,0,2762724,2762724
2014,NH,Natural Gas,8776582.88,0,8776582.88
2014,NH,Nuclear,0,20336530,20336530
2014,NH,Other,99278.54,0,99278.54
2014,NH,Other Biomass,250785.18,0,250785.18
2014,NH,Petroleum,574899.68,0,574899.68
2014,NH,Total,0,39076789.96,39076789.96
2014,NH,Wind,0,823162,823162
2014,NH,Wood and Wood Derived Fuels,2830830.23,0,2830830.23
2014,NJ,Coal,5038212.42,0,5038212.42
2014,NJ,Hydroelectric Conventional,0,34592,34592
2014,NJ,Natural Gas,62820682.75,0,62820682.75
2014,NJ,Nuclear,0,63014242,63014242
2014,NJ,Other,1280267.62,0,1280267.62
2014,NJ,Other Biomass,1996852.66,0,1996852.66
2014,NJ,Other Gases,323363.24,0,323363.24
2014,NJ,Petroleum,993552.21,0,993552.21
2014,NJ,Pumped Storage,0,-473808,-473808
2014,NJ,Solar Thermal and Photovoltaic,0,1028504.8,1028504.8
2014,NJ,Total,0,136102171.7,136102171.7
2014,NJ,Wind,0,45710,45710
2014,NM,Coal,40711262.62,0,40711262.62
2014,NM,Geothermal,17472,0,17472
2014,NM,Hydroelectric Conventional,0,196762,196762
2014,NM,Natural Gas,17951312.28,0,17951312.28
2014,NM,Other,1330,0,1330
2014,NM,Other Biomass,28358.86,0,28358.86
2014,NM,Petroleum,126313.56,0,126313.56
2014,NM,Solar Thermal and Photovoltaic,0,1030108.42,1030108.42
2014,NM,Total,0,64612419.74,64612419.74
2014,NM,Wind,0,4549500,4549500
2014,NV,Coal,13095727.18,0,13095727.18
2014,NV,Geothermal,5457576,0,5457576
2014,NV,Hydroelectric Conventional,0,4778000,4778000
2014,NV,Natural Gas,45922710.28,0,45922710.28
2014,NV,Other,29930,0,29930
2014,NV,Other Biomass,49136,0,49136
2014,NV,Other Gases,10302.76,0,10302.76
2014,NV,Petroleum,30059.78,0,30059.78
2014,NV,Solar Thermal and Photovoltaic,0,2027364,2027364
2014,NV,Total,0,72001074,72001074
2014,NV,Wind,0,600268,600268
2014,NV,Wood and Wood Derived Fuels,0,0,0
2014,NY,Coal,9184108.22,0,9184108.22
2014,NY,Hydroelectric Conventional,0,52173804.48,52173804.48
2014,NY,Natural Gas,108759517.9,0,108759517.9
2014,NY,Nuclear,0,86077248,86077248
2014,NY,Other,1866168.78,0,1866168.78
2014,NY,Other Biomass,3337535.88,0,3337535.88
2014,NY,Other Gases,0,0,0
2014,NY,Petroleum,4272967.02,0,4272967.02
2014,NY,Pumped Storage,0,-982660,-982660
2014,NY,Solar Thermal and Photovoltaic,0,141231.28,141231.28
2014,NY,Total,0,274244404.3,274244404.3
2014,NY,Wind,0,7936814.3,7936814.3
2014,NY,Wood and Wood Derived Fuels,1477668.42,0,1477668.42
2014,OH,Coal,179758103.2,0,179758103.2
2014,OH,Hydroelectric Conventional,0,956014.44,956014.44
2014,OH,Natural Gas,47272889.98,0,47272889.98
2014,OH,Nuclear,0,32568880,32568880
2014,OH,Other,-6785.38,0,-6785.38
2014,OH,Other Biomass,941762,0,941762
2014,OH,Other Gases,1858775.27,0,1858775.27
2014,OH,Petroleum,2493345.42,0,2493345.42
2014,OH,Solar Thermal and Photovoltaic,0,107816.54,107816.54
2014,OH,Total,0,268952809.9,268952809.9
2014,OH,Wind,0,2306836,2306836
2014,OH,Wood and Wood Derived Fuels,695172.44,0,695172.44
2014,OK,Coal,59811903.58,0,59811903.58
2014,OK,Hydroelectric Conventional,0,2856946,2856946
2014,OK,Natural Gas,53282948.77,0,53282948.77
2014,OK,Other,-4557.92,0,-4557.92
2014,OK,Other Biomass,183301.16,0,183301.16
2014,OK,Petroleum,24987.85,0,24987.85
2014,OK,Pumped Storage,0,-211596,-211596
2014,OK,Total,0,140311008.6,140311008.6
2014,OK,Wind,0,23873666.08,23873666.08
2014,OK,Wood and Wood Derived Fuels,493409.08,0,493409.08
2014,OR,Coal,6385186.06,0,6385186.06
2014,OR,Geothermal,366934,0,366934
2014,OR,Hydroelectric Conventional,0,70523872,70523872
2014,OR,Natural Gas,25397915.57,0,25397915.57
2014,OR,Other,86007.86,0,86007.86
2014,OR,Other Biomass,696190.98,0,696190.98
2014,OR,Petroleum,19767.96,0,19767.96
2014,OR,Solar Thermal and Photovoltaic,0,48084.1,48084.1
2014,OR,Total,0,120239814.4,120239814.4
2014,OR,Wind,0,15110804,15110804
2014,OR,Wood and Wood Derived Fuels,1605051.88,0,1605051.88
2014,PA,Coal,157971257.1,0,157971257.1
2014,PA,Hydroelectric Conventional,0,5282314,5282314
2014,PA,Natural Gas,106042470.5,0,106042470.5
2014,PA,Nuclear,0,157429318,157429318
2014,PA,Other,1800268.38,0,1800268.38
2014,PA,Other Biomass,3808448.4,0,3808448.4
2014,PA,Other Gases,981553.88,0,981553.88
2014,PA,Petroleum,1606008.48,0,1606008.48
2014,PA,Pumped Storage,0,-1157306,-1157306
2014,PA,Solar Thermal and Photovoltaic,0,124784.84,124784.84
2014,PA,Total,0,442116731,442116731
2014,PA,Wind,0,7129460,7129460
2014,PA,Wood and Wood Derived Fuels,1098153.42,0,1098153.42
2014,RI,Coal,0,0,0
2014,RI,Hydroelectric Conventional,0,7927.92,7927.92
2014,RI,Natural Gas,11925901.95,0,11925901.95
2014,RI,Other Biomass,413388.78,0,413388.78
2014,RI,Petroleum,176837.78,0,176837.78
2014,RI,Solar Thermal and Photovoltaic,0,19606,19606
2014,RI,Total,0,12563496.44,12563496.44
2014,RI,Wind,0,19834,19834
2014,SC,Coal,57828613.6,0,57828613.6
2014,SC,Hydroelectric Conventional,0,5138252,5138252
2014,SC,Natural Gas,22813280.07,0,22813280.07
2014,SC,Nuclear,0,104837106,104837106
2014,SC,Other,92530.16,0,92530.16
2014,SC,Other Biomass,388117.4,0,388117.4
2014,SC,Petroleum,491147.5,0,491147.5
2014,SC,Pumped Storage,0,-1768990,-1768990
2014,SC,Solar Thermal and Photovoltaic,0,9570,9570
2014,SC,Total,0,194316929.9,194316929.9
2014,SC,Wood and Wood Derived Fuels,4487303.15,0,4487303.15
2014,SD,Coal,5378431.48,0,5378431.48
2014,SD,Hydroelectric Conventional,0,10996428.52,10996428.52
2014,SD,Natural Gas,929634.52,0,929634.52
2014,SD,Other,0,0,0
2014,SD,Other Biomass,0,0,0
2014,SD,Petroleum,13399,0,13399
2014,SD,Total,0,21990479.52,21990479.52
2014,SD,Wind,0,4672586,4672586
2014,TN,Coal,71749163.97,0,71749163.97
2014,TN,Hydroelectric Conventional,0,17801300,17801300
2014,TN,Natural Gas,12399235.6,0,12399235.6
2014,TN,Nuclear,0,55340012,55340012
2014,TN,Other,28082.46,0,28082.46
2014,TN,Other Biomass,179134.76,0,179134.76
2014,TN,Other Gases,26093.1,0,26093.1
2014,TN,Petroleum,370254.73,0,370254.73
2014,TN,Pumped Storage,0,-982366,-982366
2014,TN,Solar Thermal and Photovoltaic,0,54962,54962
2014,TN,Total,0,159013773,159013773
2014,TN,Wind,0,102280,102280
2014,TN,Wood and Wood Derived Fuels,1945620.34,0,1945620.34
2014,TX,Coal,296347452.8,0,296347452.8
2014,TX,Hydroelectric Conventional,0,771796.5,771796.5
2014,TX,Natural Gas,409442309.4,0,409442309.4
2014,TX,Nuclear,0,78574886,78574886
2014,TX,Other,762054.4,0,762054.4
2014,TX,Other Biomass,1466907.5,0,1466907.5
2014,TX,Other Gases,4613344.07,0,4613344.07
2014,TX,Petroleum,556065.25,0,556065.25
2014,TX,Solar Thermal and Photovoltaic,0,564702.6,564702.6
2014,TX,Total,0,875259335.8,875259335.8
2014,TX,Wind,0,80010247,80010247
2014,TX,Wood and Wood Derived Fuels,2149570.24,0,2149570.24
2014,UT,Coal,66753375.37,0,66753375.37
2014,UT,Geothermal,1043164,0,1043164
2014,UT,Hydroelectric Conventional,0,1265646,1265646
2014,UT,Natural Gas,16752840.07,0,16752840.07
2014,UT,Other,235958.78,0,235958.78
2014,UT,Other Biomass,145060.34,0,145060.34
2014,UT,Other Gases,0,0,0
2014,UT,Petroleum,48635.2,0,48635.2
2014,UT,Solar Thermal and Photovoltaic,0,4470,4470
2014,UT,Total,0,87569051.76,87569051.76
2014,UT,Wind,0,1319902,1319902
2014,VA,Coal,41637168.64,0,41637168.64
2014,VA,Hydroelectric Conventional,0,1910375.84,1910375.84
2014,VA,Natural Gas,41763131.24,0,41763131.24
2014,VA,Nuclear,0,60441954,60441954
2014,VA,Other,999534.72,0,999534.72
2014,VA,Other Biomass,2194021.36,0,2194021.36
2014,VA,Petroleum,2409813.93,0,2409813.93
2014,VA,Pumped Storage,0,-2590708,-2590708
2014,VA,Total,0,154274876.8,154274876.8
2014,VA,Wood and Wood Derived Fuels,5509585.14,0,5509585.14
2014,VT,Hydroelectric Conventional,0,2350642,2350642
2014,VT,Natural Gas,4929.04,0,4929.04
2014,VT,Nuclear,0,10121164,10121164
2014,VT,Other Biomass,46978,0,46978
2014,VT,Petroleum,10946.12,0,10946.12
2014,VT,Solar Thermal and Photovoltaic,0,47071.94,47071.94
2014,VT,Total,0,14062787.94,14062787.94
2014,VT,Wind,0,622620,622620
2014,VT,Wood and Wood Derived Fuels,858436.84,0,858436.84
2014,WA,Coal,13439856.5,0,13439856.5
2014,WA,Hydroelectric Conventional,0,158926288.7,158926288.7
2014,WA,Natural Gas,22117630.67,0,22117630.67
2014,WA,Nuclear,0,18994642,18994642
2014,WA,Other,262534.38,0,262534.38
2014,WA,Other Biomass,626159.34,0,626159.34
2014,WA,Other Gases,673863.6,0,673863.6
2014,WA,Petroleum,47081.46,0,47081.46
2014,WA,Pumped Storage,0,-9506,-9506
2014,WA,Solar Thermal and Photovoltaic,0,1458,1458
2014,WA,Total,0,232668725,232668725
2014,WA,Wind,0,14535587.68,14535587.68
2014,WA,Wood and Wood Derived Fuels,3053128.75,0,3053128.75
2014,WI,Coal,74898528.69,0,74898528.69
2014,WI,Hydroelectric Conventional,0,4943546.04,4943546.04
2014,WI,Natural Gas,16107005.19,0,16107005.19
2014,WI,Nuclear,0,18894192,18894192
2014,WI,Other,123473.96,0,123473.96
2014,WI,Other Biomass,1084629.91,0,1084629.91
2014,WI,Petroleum,638063.26,0,638063.26
2014,WI,Solar Thermal and Photovoltaic,0,2388,2388
2014,WI,Total,0,122129591.4,122129591.4
2014,WI,Wind,0,3236002,3236002
2014,WI,Wood and Wood Derived Fuels,2201762.32,0,2201762.32
2014,WV,Coal,155029290.3,0,155029290.3
2014,WV,Hydroelectric Conventional,0,2483948,2483948
2014,WV,Natural Gas,1306603.39,0,1306603.39
2014,WV,Other,0,0,0
2014,WV,Other Biomass,9230.08,0,9230.08
2014,WV,Other Gases,61755.8,0,61755.8
2014,WV,Petroleum,325559.83,0,325559.83
2014,WV,Total,0,162119153.4,162119153.4
2014,WV,Wind,0,2902766,2902766
2014,WY,Coal,86817302.07,0,86817302.07
2014,WY,Hydroelectric Conventional,0,1737420.3,1737420.3
2014,WY,Natural Gas,1114242.79,0,1114242.79
2014,WY,Other,148105.82,0,148105.82
2014,WY,Other Gases,673535.28,0,673535.28
2014,WY,Petroleum,90246.48,0,90246.48
2014,WY,Total,0,99392366.72,99392366.72
2014,WY,Wind,0,8811514,8811514
2015,AK,Coal,1335099,0,1335099
2015,AK,Hydroelectric Conventional,0,3137858,3137858
2015,AK,Natural Gas,6179426,0,6179426
2015,AK,Other,-4814,0,-4814
2015,AK,Other Biomass,109784,0,109784
2015,AK,Petroleum,1493134,0,1493134
2015,AK,Total,0,12569875,12569875
2015,AK,Wind,0,319388,319388
2015,AK,Wood and Wood Derived Fuels,0,0,0
2015,AL,Coal,82820859,0,82820859
2015,AL,Hydroelectric Conventional,0,19723608,19723608
2015,AL,Natural Gas,111688913,0,111688913
2015,AL,Nuclear,0,83902764,83902764
2015,AL,Other,0,0,0
2015,AL,Other Biomass,87260,0,87260
2015,AL,Other Gases,71724,0,71724
2015,AL,Petroleum,168416,0,168416
2015,AL,Total,0,304954854,304954854
2015,AL,Wood and Wood Derived Fuels,6491308,0,6491308
2015,AR,Coal,43480066,0,43480066
2015,AR,Hydroelectric Conventional,0,7138390,7138390
2015,AR,Natural Gas,29732572,0,29732572
2015,AR,Nuclear,0,27675588,27675588
2015,AR,Other,24250,0,24250
2015,AR,Other Biomass,178580,0,178580
2015,AR,Petroleum,120888,0,120888
2015,AR,Pumped Storage,0,63334,63334
2015,AR,Solar Thermal and Photovoltaic,0,1854,1854
2015,AR,Total,0,111118856,111118856
2015,AR,Wood and Wood Derived Fuels,2703334,0,2703334
2015,AZ,Coal,72334338,0,72334338
2015,AZ,Hydroelectric Conventional,0,13071444,13071444
2015,AZ,Natural Gas,67314205,0,67314205
2015,AZ,Nuclear,0,65051190,65051190
2015,AZ,Other Biomass,99288,0,99288
2015,AZ,Petroleum,96236,0,96236
2015,AZ,Pumped Storage,0,146140,146140
2015,AZ,Solar Thermal and Photovoltaic,0,6913216,6913216
2015,AZ,Total,0,226284095,226284095
2015,AZ,Wind,0,904070,904070
2015,AZ,Wood and Wood Derived Fuels,353968,0,353968
2015,CA,Coal,595748,0,595748
2015,CA,Geothermal,23766270,0,23766270
2015,CA,Hydroelectric Conventional,0,27616996,27616996
2015,CA,Natural Gas,232279218,0,232279218
2015,CA,Nuclear,0,37010770,37010770
2015,CA,Other,1623433,0,1623433
2015,CA,Other Biomass,5767458,0,5767458
2015,CA,Other Gases,3097276,0,3097276
2015,CA,Petroleum,169030,0,169030
2015,CA,Pumped Storage,0,225300,225300
2015,CA,Solar Thermal and Photovoltaic,0,29628768,29628768
2015,CA,Total,0,393407717,393407717
2015,CA,Wind,0,24459118,24459118
2015,CA,Wood and Wood Derived Fuels,7168330,0,7168330
2015,CO,Coal,63081789,0,63081789
2015,CO,Hydroelectric Conventional,0,3240322,3240322
2015,CO,Natural Gas,23287499,0,23287499
2015,CO,Other,104648,0,104648
2015,CO,Other Biomass,159448,0,159448
2015,CO,Petroleum,14530,0,14530
2015,CO,Pumped Storage,0,-557046,-557046
2015,CO,Solar Thermal and Photovoltaic,0,502742,502742
2015,CO,Total,0,104786155,104786155
2015,CO,Wind,0,14950558,14950558
2015,CO,Wood and Wood Derived Fuels,1664,0,1664
2015,CT,Coal,1200938,0,1200938
2015,CT,Hydroelectric Conventional,0,604934,604934
2015,CT,Natural Gas,34724618,0,34724618
2015,CT,Nuclear,0,34821834,34821834
2015,CT,Other,1112937,0,1112937
2015,CT,Other Biomass,1195428,0,1195428
2015,CT,Petroleum,873583,0,873583
2015,CT,Pumped Storage,0,-7414,-7414
2015,CT,Solar Thermal and Photovoltaic,0,34878,34878
2015,CT,Total,0,74941245,74941245
2015,CT,Wood and Wood Derived Fuels,379508,0,379508
2015,DC,Natural Gas,45306,0,45306
2015,DC,Other Biomass,61998,0,61998
2015,DC,Petroleum,196,0,196
2015,DC,Total,0,107500,107500
2015,DE,Coal,1197176,0,1197176
2015,DE,Natural Gas,13378535,0,13378535
2015,DE,Other Biomass,152596,0,152596
2015,DE,Other Gases,476162,0,476162
2015,DE,Petroleum,308267,0,308267
2015,DE,Solar Thermal and Photovoltaic,0,97023,97023
2015,DE,Total,0,15620011,15620011
2015,DE,Wind,0,10252,10252
2015,FL,Coal,85808018,0,85808018
2015,FL,Hydroelectric Conventional,0,488588,488588
2015,FL,Natural Gas,311648304,0,311648304
2015,FL,Nuclear,0,56243832,56243832
2015,FL,Other,6041091,0,6041091
2015,FL,Other Biomass,5003718,0,5003718
2015,FL,Other Gases,9548,0,9548
2015,FL,Petroleum,4299030,0,4299030
2015,FL,Solar Thermal and Photovoltaic,0,447866,447866
2015,FL,Total,0,474825266,474825266
2015,FL,Wood and Wood Derived Fuels,4835273,0,4835273
2015,GA,Coal,74261260,0,74261260
2015,GA,Hydroelectric Conventional,0,5967126,5967126
2015,GA,Natural Gas,100938531,0,100938531
2015,GA,Nuclear,0,67676924,67676924
2015,GA,Other,174234,0,174234
2015,GA,Other Biomass,681600,0,681600
2015,GA,Petroleum,520743,0,520743
2015,GA,Pumped Storage,0,-1629064,-1629064
2015,GA,Solar Thermal and Photovoltaic,0,258904,258904
2015,GA,Total,0,257635796,257635796
2015,GA,Wood and Wood Derived Fuels,8785536,0,8785536
2015,HI,Coal,2674824,0,2674824
2015,HI,Geothermal,460680,0,460680
2015,HI,Hydroelectric Conventional,0,242340,242340
2015,HI,Other,738326,0,738326
2015,HI,Other Biomass,641883,0,641883
2015,HI,Other Gases,100310,0,100310
2015,HI,Petroleum,14046299,0,14046299
2015,HI,Solar Thermal and Photovoltaic,0,108794,108794
2015,HI,Total,0,20239000,20239000
2015,HI,Wind,0,1225544,1225544
2015,IA,Coal,59622150,0,59622150
2015,IA,Hydroelectric Conventional,0,1920290,1920290
2015,IA,Natural Gas,4796270,0,4796270
2015,IA,Nuclear,0,10486892,10486892
2015,IA,Other,10102,0,10102
2015,IA,Other Biomass,512296,0,512296
2015,IA,Petroleum,220583,0,220583
2015,IA,Total,0,113317837,113317837
2015,IA,Wind,0,35745264,35745264
2015,IA,Wood and Wood Derived Fuels,3990,0,3990
2015,ID,Coal,157986,0,157986
2015,ID,Geothermal,151200,0,151200
2015,ID,Hydroelectric Conventional,0,17513244,17513244
2015,ID,Natural Gas,7607176,0,7607176
2015,ID,Other,161536,0,161536
2015,ID,Other Biomass,350962,0,350962
2015,ID,Petroleum,122,0,122
2015,ID,Total,0,31334190,31334190
2015,ID,Wind,0,4540372,4540372
2015,ID,Wood and Wood Derived Fuels,851592,0,851592
2015,IL,Coal,147547412,0,147547412
2015,IL,Hydroelectric Conventional,0,248920,248920
2015,IL,Natural Gas,21727765,0,21727765
2015,IL,Nuclear,0,194564278,194564278
2015,IL,Other,496424,0,496424
2015,IL,Other Biomass,1053642,0,1053642
2015,IL,Other Gases,560120,0,560120
2015,IL,Petroleum,112186,0,112186
2015,IL,Solar Thermal and Photovoltaic,0,98720,98720
2015,IL,Total,0,387904079,387904079
2015,IL,Wind,0,21494540,21494540
2015,IL,Wood and Wood Derived Fuels,72,0,72
2015,IN,Coal,156461374,0,156461374
2015,IN,Hydroelectric Conventional,0,762472,762472
2015,IN,Natural Gas,32525974,0,32525974
2015,IN,Other,840142,0,840142
2015,IN,Other Biomass,892815,0,892815
2015,IN,Other Gases,4537276,0,4537276
2015,IN,Petroleum,2676006,0,2676006
2015,IN,Solar Thermal and Photovoltaic,0,312196,312196
2015,IN,Total,0,208038550,208038550
2015,IN,Wind,0,9030294,9030294
2015,IN,Wood and Wood Derived Fuels,0,0,0
2015,KS,Coal,49186668,0,49186668
2015,KS,Hydroelectric Conventional,0,37926,37926
2015,KS,Natural Gas,2347804,0,2347804
2015,KS,Nuclear,0,17260356,17260356
2015,KS,Other,0,0,0
2015,KS,Other Biomass,123874,0,123874
2015,KS,Petroleum,97004,0,97004
2015,KS,Solar Thermal and Photovoltaic,0,3612,3612
2015,KS,Total,0,91054248,91054248
2015,KS,Wind,0,21997002,21997002
2015,KY,Coal,145240858,0,145240858
2015,KY,Hydroelectric Conventional,0,6806962,6806962
2015,KY,Natural Gas,11899453,0,11899453
2015,KY,Other,103392,0,103392
2015,KY,Other Biomass,184598,0,184598
2015,KY,Petroleum,2154426,0,2154426
2015,KY,Total,0,167087342,167087342
2015,KY,Wood and Wood Derived Fuels,697654,0,697654
2015,LA,Coal,30329916,0,30329916
2015,LA,Hydroelectric Conventional,0,1998072,1998072
2015,LA,Natural Gas,132421664,0,132421664
2015,LA,Nuclear,0,30601472,30601472
2015,LA,Other,1576432,0,1576432
2015,LA,Other Biomass,192550,0,192550
2015,LA,Other Gases,4801494,0,4801494
2015,LA,Petroleum,8486171,0,8486171
2015,LA,Total,0,215624708,215624708
2015,LA,Wood and Wood Derived Fuels,5216936,0,5216936
2015,MA,Coal,4505328,0,4505328
2015,MA,Hydroelectric Conventional,0,1654368,1654368
2015,MA,Natural Gas,42014822,0,42014822
2015,MA,Nuclear,0,9989612,9989612
2015,MA,Other,1735612,0,1735612
2015,MA,Other Biomass,2094206,0,2094206
2015,MA,Petroleum,1554151,0,1554151
2015,MA,Pumped Storage,0,-947762,-947762
2015,MA,Solar Thermal and Photovoltaic,0,902732,902732
2015,MA,Total,0,64171938,64171938
2015,MA,Wind,0,429332,429332
2015,MA,Wood and Wood Derived Fuels,239538,0,239538
2015,MD,Coal,27851209,0,27851209
2015,MD,Hydroelectric Conventional,0,3246380,3246380
2015,MD,Natural Gas,9110690,0,9110690
2015,MD,Nuclear,0,29286650,29286650
2015,MD,Other,635869,0,635869
2015,MD,Other Biomass,806478,0,806478
2015,MD,Petroleum,464695,0,464695
2015,MD,Solar Thermal and Photovoltaic,0,237603,237603
2015,MD,Total,0,72731088,72731088
2015,MD,Wind,0,869190,869190
2015,MD,Wood and Wood Derived Fuels,222325,0,222325
2015,ME,Coal,183802,0,183802
2015,ME,Hydroelectric Conventional,0,6721054,6721054
2015,ME,Natural Gas,5903812,0,5903812
2015,ME,Other,680026,0,680026
2015,ME,Other Biomass,365842,0,365842
2015,ME,Petroleum,1096526,0,1096526
2015,ME,Total,0,23482530,23482530
2015,ME,Wind,0,2591416,2591416
2015,ME,Wood and Wood Derived Fuels,5940051,0,5940051
2015,MI,Coal,105768066,0,105768066
2015,MI,Hydroelectric Conventional,0,2998446,2998446
2015,MI,Natural Gas,40089596,0,40089596
2015,MI,Nuclear,0,58667572,58667572
2015,MI,Other,809604,0,809604
2015,MI,Other Biomass,2076526,0,2076526
2015,MI,Other Gases,2425556,0,2425556
2015,MI,Petroleum,1652983,0,1652983
2015,MI,Pumped Storage,0,-961642,-961642
2015,MI,Solar Thermal and Photovoltaic,0,2380,2380
2015,MI,Total,0,226016100,226016100
2015,MI,Wind,0,9593796,9593796
2015,MI,Wood and Wood Derived Fuels,2893216,0,2893216
2015,MN,Coal,49394196,0,49394196
2015,MN,Hydroelectric Conventional,0,1698108,1698108
2015,MN,Natural Gas,14778876,0,14778876
2015,MN,Nuclear,0,24077212,24077212
2015,MN,Other,779952,0,779952
2015,MN,Other Biomass,1257652,0,1257652
2015,MN,Petroleum,55878,0,55878
2015,MN,Solar Thermal and Photovoltaic,0,5578,5578
2015,MN,Total,0,113959536,113959536
2015,MN,Wind,0,19557690,19557690
2015,MN,Wood and Wood Derived Fuels,2354393,0,2354393
2015,MO,Coal,130651042,0,130651042
2015,MO,Hydroelectric Conventional,0,3190040,3190040
2015,MO,Natural Gas,9192827,0,9192827
2015,MO,Nuclear,0,20880164,20880164
2015,MO,Other,115128,0,115128
2015,MO,Other Biomass,199682,0,199682
2015,MO,Petroleum,197684,0,197684
2015,MO,Pumped Storage,0,695498,695498
2015,MO,Solar Thermal and Photovoltaic,0,33796,33796
2015,MO,Total,0,167280134,167280134
2015,MO,Wind,0,2066152,2066152
2015,MO,Wood and Wood Derived Fuels,58122,0,58122
2015,MS,Coal,12799210,0,12799210
2015,MS,Natural Gas,90233886,0,90233886
2015,MS,Nuclear,0,23429176,23429176
2015,MS,Other,12132,0,12132
2015,MS,Other Biomass,26908,0,26908
2015,MS,Petroleum,28258,0,28258
2015,MS,Total,0,129515728,129515728
2015,MS,Wood and Wood Derived Fuels,2986156,0,2986156
2015,MT,Coal,32026411,0,32026411
2015,MT,Hydroelectric Conventional,0,19775458,19775458
2015,MT,Natural Gas,1198412,0,1198412
2015,MT,Other,605544,0,605544
2015,MT,Other Gases,34110,0,34110
2015,MT,Petroleum,992852,0,992852
2015,MT,Total,0,58604802,58604802
2015,MT,Wind,0,3929452,3929452
2015,MT,Wood and Wood Derived Fuels,42562,0,42562
2015,NC,Coal,79844335,0,79844335
2015,NC,Hydroelectric Conventional,0,9484008,9484008
2015,NC,Natural Gas,73089192,0,73089192
2015,NC,Nuclear,0,84193522,84193522
2015,NC,Other,1370566,0,1370566
2015,NC,Other Biomass,1088049,0,1088049
2015,NC,Petroleum,869175,0,869175
2015,NC,Pumped Storage,0,188,188
2015,NC,Solar Thermal and Photovoltaic,0,2747158,2747158
2015,NC,Total,0,256776890,256776890
2015,NC,Wood and Wood Derived Fuels,4090697,0,4090697
2015,ND,Coal,55468826,0,55468826
2015,ND,Hydroelectric Conventional,0,4188336,4188336
2015,ND,Natural Gas,1422088,0,1422088
2015,ND,Other,84336,0,84336
2015,ND,Other Biomass,7188,0,7188
2015,ND,Other Gases,78126,0,78126
2015,ND,Petroleum,52917,0,52917
2015,ND,Total,0,74313224,74313224
2015,ND,Wind,0,13011408,13011408
2015,NE,Coal,48370842,0,48370842
2015,NE,Hydroelectric Conventional,0,3369960,3369960
2015,NE,Natural Gas,861461,0,861461
2015,NE,Nuclear,0,20649456,20649456
2015,NE,Other,0,0,0
2015,NE,Other Biomass,141906,0,141906
2015,NE,Petroleum,12230,0,12230
2015,NE,Total,0,79766782,79766782
2015,NE,Wind,0,6360926,6360926
2015,NE,Wood and Wood Derived Fuels,0,0,0
2015,NH,Coal,1873324,0,1873324
2015,NH,Hydroelectric Conventional,0,2540444,2540444
2015,NH,Natural Gas,12103390,0,12103390
2015,NH,Nuclear,0,18968408,18968408
2015,NH,Other,99440,0,99440
2015,NH,Other Biomass,237301,0,237301
2015,NH,Petroleum,351128,0,351128
2015,NH,Total,0,40031787,40031787
2015,NH,Wind,0,846992,846992
2015,NH,Wood and Wood Derived Fuels,3011362,0,3011362
2015,NJ,Coal,3518192,0,3518192
2015,NJ,Hydroelectric Conventional,0,19082,19082
2015,NJ,Natural Gas,73948913,0,73948913
2015,NJ,Nuclear,0,66523520,66523520
2015,NJ,Other,1164986,0,1164986
2015,NJ,Other Biomass,1891387,0,1891387
2015,NJ,Other Gases,442066,0,442066
2015,NJ,Petroleum,749872,0,749872
2015,NJ,Pumped Storage,0,-339154,-339154
2015,NJ,Solar Thermal and Photovoltaic,0,1255780,1255780
2015,NJ,Total,0,149217719,149217719
2015,NJ,Wind,0,43078,43078
2015,NM,Coal,40879064,0,40879064
2015,NM,Geothermal,19350,0,19350
2015,NM,Hydroelectric Conventional,0,198946,198946
2015,NM,Natural Gas,18729248,0,18729248
2015,NM,Other,1330,0,1330
2015,NM,Other Biomass,39146,0,39146
2015,NM,Petroleum,125916,0,125916
2015,NM,Solar Thermal and Photovoltaic,0,1229754,1229754
2015,NM,Total,0,65402796,65402796
2015,NM,Wind,0,4180042,4180042
2015,NV,Coal,5314578,0,5314578
2015,NV,Geothermal,6221008,0,6221008
2015,NV,Hydroelectric Conventional,0,4528272,4528272
2015,NV,Natural Gas,57999027,0,57999027
2015,NV,Other,2026,0,2026
2015,NV,Other Biomass,51390,0,51390
2015,NV,Other Gases,11046,0,11046
2015,NV,Petroleum,31964,0,31964
2015,NV,Solar Thermal and Photovoltaic,0,3314810,3314810
2015,NV,Total,0,78093568,78093568
2015,NV,Wind,0,619448,619448
2015,NY,Coal,4760131,0,4760131
2015,NY,Hydroelectric Conventional,0,52029040,52029040
2015,NY,Natural Gas,113846830,0,113846830
2015,NY,Nuclear,0,89205742,89205742
2015,NY,Other,1837633,0,1837633
2015,NY,Other Biomass,3249542,0,3249542
2015,NY,Other Gases,0,0,0
2015,NY,Petroleum,3784585,0,3784585
2015,NY,Pumped Storage,0,-845624,-845624
2015,NY,Solar Thermal and Photovoltaic,0,201052,201052
2015,NY,Total,0,277255441,277255441
2015,NY,Wind,0,7953960,7953960
2015,NY,Wood and Wood Derived Fuels,1232548,0,1232548
2015,OH,Coal,143419059,0,143419059
2015,OH,Hydroelectric Conventional,0,913338,913338
2015,OH,Natural Gas,56067431,0,56067431
2015,OH,Nuclear,0,34753472,34753472
2015,OH,Other,-6270,0,-6270
2015,OH,Other Biomass,945711,0,945711
2015,OH,Other Gases,1890042,0,1890042
2015,OH,Petroleum,2634054,0,2634054
2015,OH,Solar Thermal and Photovoltaic,0,112144,112144
2015,OH,Total,0,243786803,243786803
2015,OH,Wind,0,2406016,2406016
2015,OH,Wood and Wood Derived Fuels,651804,0,651804
2015,OK,Coal,49734064,0,49734064
2015,OK,Hydroelectric Conventional,0,5327802,5327802
2015,OK,Natural Gas,68572653,0,68572653
2015,OK,Other,22800,0,22800
2015,OK,Other Biomass,182402,0,182402
2015,OK,Petroleum,21624,0,21624
2015,OK,Pumped Storage,0,-144992,-144992
2015,OK,Solar Thermal and Photovoltaic,0,3112,3112
2015,OK,Total,0,152271192,152271192
2015,OK,Wind,0,28061794,28061794
2015,OK,Wood and Wood Derived Fuels,489934,0,489934
2015,OR,Coal,4754718,0,4754718
2015,OR,Geothermal,357608,0,357608
2015,OR,Hydroelectric Conventional,0,62507702,62507702
2015,OR,Natural Gas,32474184,0,32474184
2015,OR,Other,83670,0,83670
2015,OR,Other Biomass,737051,0,737051
2015,OR,Petroleum,12130,0,12130
2015,OR,Solar Thermal and Photovoltaic,0,48416,48416
2015,OR,Total,0,115733070,115733070
2015,OR,Wind,0,13263110,13263110
2015,OR,Wood and Wood Derived Fuels,1494478,0,1494478
2015,PA,Coal,129274466,0,129274466
2015,PA,Hydroelectric Conventional,0,5207408,5207408
2015,PA,Natural Gas,118909310,0,118909310
2015,PA,Nuclear,0,161033504,161033504
2015,PA,Other,1797249,0,1797249
2015,PA,Other Biomass,3868236,0,3868236
2015,PA,Other Gases,840474,0,840474
2015,PA,Petroleum,1458975,0,1458975
2015,PA,Pumped Storage,0,-1017854,-1017854
2015,PA,Solar Thermal and Photovoltaic,0,127788,127788
2015,PA,Total,0,429144581,429144581
2015,PA,Wind,0,6705344,6705344
2015,PA,Wood and Wood Derived Fuels,939684,0,939684
2015,RI,Coal,0,0,0
2015,RI,Hydroelectric Conventional,0,6296,6296
2015,RI,Natural Gas,13171886,0,13171886
2015,RI,Other Biomass,422476,0,422476
2015,RI,Petroleum,228546,0,228546
2015,RI,Solar Thermal and Photovoltaic,0,28702,28702
2015,RI,Total,0,13878038,13878038
2015,RI,Wind,0,20134,20134
2015,SC,Coal,45262346,0,45262346
2015,SC,Hydroelectric Conventional,0,5128720,5128720
2015,SC,Natural Gas,33098613,0,33098613
2015,SC,Nuclear,0,106312640,106312640
2015,SC,Other,97277,0,97277
2015,SC,Other Biomass,372772,0,372772
2015,SC,Petroleum,386390,0,386390
2015,SC,Pumped Storage,0,-1808758,-1808758
2015,SC,Solar Thermal and Photovoltaic,0,8440,8440
2015,SC,Total,0,193064426,193064426
2015,SC,Wood and Wood Derived Fuels,4205987,0,4205987
2015,SD,Coal,2990158,0,2990158
2015,SD,Hydroelectric Conventional,0,9700970,9700970
2015,SD,Natural Gas,1545506,0,1545506
2015,SD,Other,0,0,0
2015,SD,Other Biomass,0,0,0
2015,SD,Petroleum,34406,0,34406
2015,SD,Total,0,19266066,19266066
2015,SD,Wind,0,4995026,4995026
2015,TN,Coal,61172663,0,61172663
2015,TN,Hydroelectric Conventional,0,19162480,19162480
2015,TN,Natural Gas,18647460,0,18647460
2015,TN,Nuclear,0,49920944,49920944
2015,TN,Other,41318,0,41318
2015,TN,Other Biomass,163536,0,163536
2015,TN,Other Gases,23920,0,23920
2015,TN,Petroleum,270267,0,270267
2015,TN,Pumped Storage,0,-1061404,-1061404
2015,TN,Solar Thermal and Photovoltaic,0,152294,152294
2015,TN,Total,0,150429273,150429273
2015,TN,Wind,0,91682,91682
2015,TN,Wood and Wood Derived Fuels,1844110,0,1844110
2015,TX,Coal,243108567,0,243108567
2015,TX,Hydroelectric Conventional,0,1912820,1912820
2015,TX,Natural Gas,475462854,0,475462854
2015,TX,Nuclear,0,78709354,78709354
2015,TX,Other,1468648,0,1468648
2015,TX,Other Biomass,1567290,0,1567290
2015,TX,Other Gases,5158602,0,5158602
2015,TX,Petroleum,483128,0,483128
2015,TX,Solar Thermal and Photovoltaic,0,801518,801518
2015,TX,Total,0,899652673,899652673
2015,TX,Wind,0,89666730,89666730
2015,TX,Wood and Wood Derived Fuels,1313160,0,1313160
2015,UT,Coal,63312978,0,63312978
2015,UT,Geothermal,859034,0,859034
2015,UT,Hydroelectric Conventional,0,1537546,1537546
2015,UT,Natural Gas,16435331,0,16435331
2015,UT,Other,211464,0,211464
2015,UT,Other Biomass,170262,0,170262
2015,UT,Other Gases,16608,0,16608
2015,UT,Petroleum,39465,0,39465
2015,UT,Solar Thermal and Photovoltaic,0,63718,63718
2015,UT,Total,0,83898241,83898241
2015,UT,Wind,0,1251834,1251834
2015,VA,Coal,34462851,0,34462851
2015,VA,Hydroelectric Conventional,0,2316856,2316856
2015,VA,Natural Gas,66568431,0,66568431
2015,VA,Nuclear,0,56120716,56120716
2015,VA,Other,923106,0,923106
2015,VA,Other Biomass,2206063,0,2206063
2015,VA,Petroleum,2215670,0,2215670
2015,VA,Pumped Storage,0,-2072764,-2072764
2015,VA,Total,0,168823184,168823184
2015,VA,Wood and Wood Derived Fuels,6082253,0,6082253
2015,VT,Hydroelectric Conventional,0,2278996,2278996
2015,VT,Natural Gas,2987,0,2987
2015,VT,Other Biomass,37986,0,37986
2015,VT,Petroleum,6112,0,6112
2015,VT,Solar Thermal and Photovoltaic,0,96044,96044
2015,VT,Total,0,3964094,3964094
2015,VT,Wind,0,650730,650730
2015,VT,Wood and Wood Derived Fuels,891240,0,891240
2015,WA,Coal,10103830,0,10103830
2015,WA,Hydroelectric Conventional,0,146809832,146809832
2015,WA,Natural Gas,26091855,0,26091855
2015,WA,Nuclear,0,16321824,16321824
2015,WA,Other,199430,0,199430
2015,WA,Other Biomass,597897,0,597897
2015,WA,Other Gases,790008,0,790008
2015,WA,Petroleum,43342,0,43342
2015,WA,Pumped Storage,0,80042,80042
2015,WA,Solar Thermal and Photovoltaic,0,1580,1580
2015,WA,Total,0,218574916,218574916
2015,WA,Wind,0,14150770,14150770
2015,WA,Wood and Wood Derived Fuels,3384507,0,3384507
2015,WI,Coal,74361094,0,74361094
2015,WI,Hydroelectric Conventional,0,4681362,4681362
2015,WI,Natural Gas,26797551,0,26797551
2015,WI,Nuclear,0,20016366,20016366
2015,WI,Other,125058,0,125058
2015,WI,Other Biomass,1142118,0,1142118
2015,WI,Petroleum,415500,0,415500
2015,WI,Solar Thermal and Photovoltaic,0,2834,2834
2015,WI,Total,0,132720365,132720365
2015,WI,Wind,0,3178762,3178762
2015,WI,Wood and Wood Derived Fuels,1999722,0,1999722
2015,WV,Coal,136112185,0,136112185
2015,WV,Hydroelectric Conventional,0,2770086,2770086
2015,WV,Natural Gas,2607261,0,2607261
2015,WV,Other,0,0,0
2015,WV,Other Biomass,9960,0,9960
2015,WV,Other Gases,58154,0,58154
2015,WV,Petroleum,280428,0,280428
2015,WV,Total,0,144590538,144590538
2015,WV,Wind,0,2752464,2752464
2015,WY,Coal,86182378,0,86182378
2015,WY,Hydroelectric Conventional,0,1736522,1736522
2015,WY,Natural Gas,1444609,0,1444609
2015,WY,Other,155544,0,155544
2015,WY,Other Gases,810772,0,810772
2015,WY,Petroleum,89797,0,89797
2015,WY,Total,0,97933038,97933038
2015,WY,Wind,0,7513416,7513416
2016,AK,Coal,1188278,0,1188278
2016,AK,Hydroelectric Conventional,0,3318304,3318304
2016,AK,Natural Gas,6080974,0,6080974
2016,AK,Other,-4784,0,-4784
2016,AK,Other Biomass,86034,0,86034
2016,AK,Petroleum,1662659,0,1662659
2016,AK,Total,0,12670067,12670067
2016,AK,Wind,0,338602,338602
2016,AK,Wood and Wood Derived Fuels,0,0,0
2016,AL,Coal,68516811,0,68516811
2016,AL,Hydroelectric Conventional,0,13969606,13969606
2016,AL,Natural Gas,115607236,0,115607236
2016,AL,Nuclear,0,79803758,79803758
2016,AL,Other,0,0,0
2016,AL,Other Biomass,76220,0,76220
2016,AL,Other Gases,48106,0,48106
2016,AL,Petroleum,91665,0,91665
2016,AL,Solar Thermal and Photovoltaic,0,62522,62522
2016,AL,Total,0,284770196,284770196
2016,AL,Wood and Wood Derived Fuels,6594272,0,6594272
2016,AR,Coal,47600141,0,47600141
2016,AR,Hydroelectric Conventional,0,7139972,7139972
2016,AR,Natural Gas,36342374,0,36342374
2016,AR,Nuclear,0,26842044,26842044
2016,AR,Other,11274,0,11274
2016,AR,Other Biomass,225414,0,225414
2016,AR,Petroleum,84725,0,84725
2016,AR,Pumped Storage,0,77648,77648
2016,AR,Solar Thermal and Photovoltaic,0,52284,52284
2016,AR,Total,0,120890118,120890118
2016,AR,Wood and Wood Derived Fuels,2514242,0,2514242
2016,AZ,Coal,60806784,0,60806784
2016,AZ,Hydroelectric Conventional,0,14335526,14335526
2016,AZ,Natural Gas,68365616,0,68365616
2016,AZ,Nuclear,0,64754954,64754954
2016,AZ,Other Biomass,76484,0,76484
2016,AZ,Petroleum,103190,0,103190
2016,AZ,Pumped Storage,0,117260,117260
2016,AZ,Solar Thermal and Photovoltaic,0,7531650,7531650
2016,AZ,Total,0,217526899,217526899
2016,AZ,Wind,0,1083164,1083164
2016,AZ,Wood and Wood Derived Fuels,352272,0,352272
2016,CA,Coal,637752,0,637752
2016,CA,Geothermal,22914598,0,22914598
2016,CA,Hydroelectric Conventional,0,57884242,57884242
2016,CA,Natural Gas,194147328,0,194147328
2016,CA,Nuclear,0,37815156,37815156
2016,CA,Other,1331329,0,1331329
2016,CA,Other Biomass,5819860,0,5819860
2016,CA,Other Gases,2853632,0,2853632
2016,CA,Petroleum,351162,0,351162
2016,CA,Pumped Storage,0,-518698,-518698
2016,CA,Solar Thermal and Photovoltaic,0,37613423,37613423
2016,CA,Total,0,393926431,393926431
2016,CA,Wind,0,27018078,27018078
2016,CA,Wood and Wood Derived Fuels,6058570,0,6058570
2016,CO,Coal,59897350,0,59897350
2016,CO,Hydroelectric Conventional,0,3805142,3805142
2016,CO,Natural Gas,25358878,0,25358878
2016,CO,Other,106776,0,106776
2016,CO,Other Biomass,152966,0,152966
2016,CO,Petroleum,13950,0,13950
2016,CO,Pumped Storage,0,-588372,-588372
2016,CO,Solar Thermal and Photovoltaic,0,1076218,1076218
2016,CO,Total,0,108836960,108836960
2016,CO,Wind,0,18842408,18842408
2016,CO,Wood and Wood Derived Fuels,171644,0,171644
2016,CT,Coal,354740,0,354740
2016,CT,Hydroelectric Conventional,0,448290,448290
2016,CT,Natural Gas,35903007,0,35903007
2016,CT,Nuclear,0,33150984,33150984
2016,CT,Other,1154796,0,1154796
2016,CT,Other Biomass,1237676,0,1237676
2016,CT,Petroleum,183470,0,183470
2016,CT,Pumped Storage,0,11174,11174
2016,CT,Solar Thermal and Photovoltaic,0,49036,49036
2016,CT,Total,0,72993120,72993120
2016,CT,Wind,0,25484,25484
2016,CT,Wood and Wood Derived Fuels,474464,0,474464
2016,DC,Natural Gas,45404,0,45404
2016,DC,Other Biomass,105542,0,105542
2016,DC,Petroleum,2002,0,2002
2016,DC,Total,0,152948,152948
2016,DE,Coal,958700,0,958700
2016,DE,Natural Gas,15574938,0,15574938
2016,DE,Other Biomass,135974,0,135974
2016,DE,Other Gases,554954,0,554954
2016,DE,Petroleum,125142,0,125142
2016,DE,Solar Thermal and Photovoltaic,0,102172,102172
2016,DE,Total,0,17462522,17462522
2016,DE,Wind,0,10642,10642
2016,FL,Coal,78858936,0,78858936
2016,FL,Hydroelectric Conventional,0,349102,349102
2016,FL,Natural Gas,316990890,0,316990890
2016,FL,Nuclear,0,58640044,58640044
2016,FL,Other,6301050,0,6301050
2016,FL,Other Biomass,5342564,0,5342564
2016,FL,Other Gases,9432,0,9432
2016,FL,Petroleum,5640606,0,5640606
2016,FL,Solar Thermal and Photovoltaic,0,447966,447966
2016,FL,Total,0,476524301,476524301
2016,FL,Wood and Wood Derived Fuels,3943712,0,3943712
2016,GA,Coal,75780948,0,75780948
2016,GA,Hydroelectric Conventional,0,6745354,6745354
2016,GA,Natural Gas,105724928,0,105724928
2016,GA,Nuclear,0,68961324,68961324
2016,GA,Other,201956,0,201956
2016,GA,Other Biomass,541774,0,541774
2016,GA,Petroleum,423691,0,423691
2016,GA,Pumped Storage,0,-1986048,-1986048
2016,GA,Solar Thermal and Photovoltaic,0,1761846,1761846
2016,GA,Total,0,266760831,266760831
2016,GA,Wood and Wood Derived Fuels,8605058,0,8605058
2016,HI,Coal,2994760,0,2994760
2016,HI,Geothermal,520204,0,520204
2016,HI,Hydroelectric Conventional,0,181698,181698
2016,HI,Other,644178,0,644178
2016,HI,Other Biomass,718932,0,718932
2016,HI,Other Gases,102012,0,102012
2016,HI,Petroleum,13280632,0,13280632
2016,HI,Solar Thermal and Photovoltaic,0,177022,177022
2016,HI,Total,0,19897690,19897690
2016,HI,Wind,0,1278254,1278254
2016,IA,Coal,50396694,0,50396694
2016,IA,Hydroelectric Conventional,0,1833578,1833578
2016,IA,Natural Gas,5921895,0,5921895
2016,IA,Nuclear,0,9405330,9405330
2016,IA,Other,24242,0,24242
2016,IA,Other Biomass,501339,0,501339
2016,IA,Petroleum,555546,0,555546
2016,IA,Solar Thermal and Photovoltaic,0,302,302
2016,IA,Total,0,108785013,108785013
2016,IA,Wind,0,40143998,40143998
2016,IA,Wood and Wood Derived Fuels,2090,0,2090
2016,ID,Coal,58376,0,58376
2016,ID,Geothermal,143990,0,143990
2016,ID,Hydroelectric Conventional,0,18066544,18066544
2016,ID,Natural Gas,6642925,0,6642925
2016,ID,Other,130096,0,130096
2016,ID,Other Biomass,236856,0,236856
2016,ID,Petroleum,366,0,366
2016,ID,Solar Thermal and Photovoltaic,0,59602,59602
2016,ID,Total,0,31321876,31321876
2016,ID,Wind,0,5156830,5156830
2016,ID,Wood and Wood Derived Fuels,826290,0,826290
2016,IL,Coal,118675604,0,118675604
2016,IL,Hydroelectric Conventional,0,265668,265668
2016,IL,Natural Gas,34969382,0,34969382
2016,IL,Nuclear,0,197214076,197214076
2016,IL,Other,547708,0,547708
2016,IL,Other Biomass,934024,0,934024
2016,IL,Other Gases,408306,0,408306
2016,IL,Petroleum,139006,0,139006
2016,IL,Solar Thermal and Photovoltaic,0,97620,97620
2016,IL,Total,0,374578263,374578263
2016,IL,Wind,0,21326868,21326868
2016,IL,Wood and Wood Derived Fuels,0,0,0
2016,IN,Coal,145066161,0,145066161
2016,IN,Hydroelectric Conventional,0,852530,852530
2016,IN,Natural Gas,39991318,0,39991318
2016,IN,Other,726100,0,726100
2016,IN,Other Biomass,865579,0,865579
2016,IN,Other Gases,4544984,0,4544984
2016,IN,Petroleum,1220814,0,1220814
2016,IN,Solar Thermal and Photovoltaic,0,451682,451682
2016,IN,Total,0,203518119,203518119
2016,IN,Wind,0,9798948,9798948
2016,IN,Wood and Wood Derived Fuels,0,0,0
2016,KS,Coal,46192128,0,46192128
2016,KS,Hydroelectric Conventional,0,61076,61076
2016,KS,Natural Gas,4054414,0,4054414
2016,KS,Nuclear,0,16492084,16492084
2016,KS,Other,2,0,2
2016,KS,Other Biomass,117664,0,117664
2016,KS,Petroleum,56648,0,56648
2016,KS,Solar Thermal and Photovoltaic,0,4204,4204
2016,KS,Total,0,95199982,95199982
2016,KS,Wind,0,28221762,28221762
2016,KY,Coal,133644116,0,133644116
2016,KY,Hydroelectric Conventional,0,6955860,6955860
2016,KY,Natural Gas,16456668,0,16456668
2016,KY,Other,99902,0,99902
2016,KY,Other Biomass,209552,0,209552
2016,KY,Petroleum,2437202,0,2437202
2016,KY,Solar Thermal and Photovoltaic,0,23464,23464
2016,KY,Total,0,160547003,160547003
2016,KY,Wood and Wood Derived Fuels,720238,0,720238
2016,LA,Coal,24027298,0,24027298
2016,LA,Hydroelectric Conventional,0,2206046,2206046
2016,LA,Natural Gas,132958285,0,132958285
2016,LA,Nuclear,0,34303652,34303652
2016,LA,Other,1453192,0,1453192
2016,LA,Other Biomass,174668,0,174668
2016,LA,Other Gases,4198140,0,4198140
2016,LA,Petroleum,9638449,0,9638449
2016,LA,Total,0,214537607,214537607
2016,LA,Wood and Wood Derived Fuels,5577878,0,5577878
2016,MA,Coal,3749864,0,3749864
2016,MA,Hydroelectric Conventional,0,1425032,1425032
2016,MA,Natural Gas,42287872,0,42287872
2016,MA,Nuclear,0,10828636,10828636
2016,MA,Other,1715864,0,1715864
2016,MA,Other Biomass,2150661,0,2150661
2016,MA,Petroleum,844563,0,844563
2016,MA,Pumped Storage,0,-1000900,-1000900
2016,MA,Solar Thermal and Photovoltaic,0,1218561,1218561
2016,MA,Total,0,63910043,63910043
2016,MA,Wind,0,432246,432246
2016,MA,Wood and Wood Derived Fuels,257644,0,257644
2016,MD,Coal,27652426,0,27652426
2016,MD,Hydroelectric Conventional,0,2784374,2784374
2016,MD,Natural Gas,10846092,0,10846092
2016,MD,Nuclear,0,29520354,29520354
2016,MD,Other,646121,0,646121
2016,MD,Other Biomass,844058,0,844058
2016,MD,Petroleum,321099,0,321099
2016,MD,Solar Thermal and Photovoltaic,0,417314,417314
2016,MD,Total,0,74333375,74333375
2016,MD,Wind,0,1054228,1054228
2016,MD,Wood and Wood Derived Fuels,247306,0,247306
2016,ME,Coal,139646,0,139646
2016,ME,Hydroelectric Conventional,0,5999376,5999376
2016,ME,Natural Gas,6996680,0,6996680
2016,ME,Other,762757,0,762757
2016,ME,Other Biomass,369853,0,369853
2016,ME,Petroleum,219848,0,219848
2016,ME,Total,0,23028854,23028854
2016,ME,Wind,0,3334206,3334206
2016,ME,Wood and Wood Derived Fuels,5206491,0,5206491
2016,MI,Coal,81053745,0,81053745
2016,MI,Hydroelectric Conventional,0,3128710,3128710
2016,MI,Natural Gas,58590307,0,58590307
2016,MI,Nuclear,0,63103420,63103420
2016,MI,Other,603291,0,603291
2016,MI,Other Biomass,1945192,0,1945192
2016,MI,Other Gases,3229244,0,3229244
2016,MI,Petroleum,1637958,0,1637958
2016,MI,Pumped Storage,0,-1503300,-1503300
2016,MI,Solar Thermal and Photovoltaic,0,18470,18470
2016,MI,Total,0,224243579,224243579
2016,MI,Wind,0,9391566,9391566
2016,MI,Wood and Wood Derived Fuels,3044977,0,3044977
2016,MN,Coal,46412578,0,46412578
2016,MN,Hydroelectric Conventional,0,2417004,2417004
2016,MN,Natural Gas,17856152,0,17856152
2016,MN,Nuclear,0,27721632,27721632
2016,MN,Other,814860,0,814860
2016,MN,Other Biomass,1348644,0,1348644
2016,MN,Petroleum,64054,0,64054
2016,MN,Solar Thermal and Photovoltaic,0,20214,20214
2016,MN,Total,0,118957505,118957505
2016,MN,Wind,0,19866974,19866974
2016,MN,Wood and Wood Derived Fuels,2435394,0,2435394
2016,MO,Coal,120643779,0,120643779
2016,MO,Hydroelectric Conventional,0,2536946,2536946
2016,MO,Natural Gas,12063137,0,12063137
2016,MO,Nuclear,0,18860358,18860358
2016,MO,Other,17958,0,17958
2016,MO,Other Biomass,182952,0,182952
2016,MO,Petroleum,156032,0,156032
2016,MO,Pumped Storage,0,358402,358402
2016,MO,Solar Thermal and Photovoltaic,0,65368,65368
2016,MO,Total,0,157223026,157223026
2016,MO,Wind,0,2243766,2243766
2016,MO,Wood and Wood Derived Fuels,94326,0,94326
2016,MS,Coal,10684052,0,10684052
2016,MS,Natural Gas,100189478,0,100189478
2016,MS,Nuclear,0,11794544,11794544
2016,MS,Other,10544,0,10544
2016,MS,Other Biomass,22838,0,22838
2016,MS,Petroleum,35570,0,35570
2016,MS,Solar Thermal and Photovoltaic,0,0,0
2016,MS,Total,0,125762590,125762590
2016,MS,Wood and Wood Derived Fuels,3025562,0,3025562
2016,MT,Coal,28538444,0,28538444
2016,MT,Hydroelectric Conventional,0,20165058,20165058
2016,MT,Natural Gas,952122,0,952122
2016,MT,Other,653736,0,653736
2016,MT,Other Gases,17172,0,17172
2016,MT,Petroleum,919846,0,919846
2016,MT,Total,0,55567058,55567058
2016,MT,Wind,0,4280382,4280382
2016,MT,Wood and Wood Derived Fuels,40300,0,40300
2016,NC,Coal,74871560,0,74871560
2016,NC,Hydroelectric Conventional,0,8834372,8834372
2016,NC,Natural Gas,78502204,0,78502204
2016,NC,Nuclear,0,85572174,85572174
2016,NC,Other,1309076,0,1309076
2016,NC,Other Biomass,1191729,0,1191729
2016,NC,Petroleum,502387,0,502387
2016,NC,Pumped Storage,0,0,0
2016,NC,Solar Thermal and Photovoltaic,0,6842256,6842256
2016,NC,Total,0,261558314,261558314
2016,NC,Wind,0,12466,12466
2016,NC,Wood and Wood Derived Fuels,3920090,0,3920090
2016,ND,Coal,53160700,0,53160700
2016,ND,Hydroelectric Conventional,0,3824010,3824010
2016,ND,Natural Gas,2142214,0,2142214
2016,ND,Other,90214,0,90214
2016,ND,Other Biomass,11212,0,11212
2016,ND,Other Gases,80492,0,80492
2016,ND,Petroleum,60217,0,60217
2016,ND,Total,0,75712904,75712904
2016,ND,Wind,0,16343844,16343844
2016,NE,Coal,43795430,0,43795430
2016,NE,Hydroelectric Conventional,0,1712816,1712816
2016,NE,Natural Gas,1075820,0,1075820
2016,NE,Nuclear,0,18701182,18701182
2016,NE,Other,0,0,0
2016,NE,Other Biomass,195635,0,195635
2016,NE,Petroleum,-35880,0,-35880
2016,NE,Solar Thermal and Photovoltaic,0,7962,7962
2016,NE,Total,0,73049738,73049738
2016,NE,Wind,0,7596774,7596774
2016,NE,Wood and Wood Derived Fuels,0,0,0
2016,NH,Coal,844034,0,844034
2016,NH,Hydroelectric Conventional,0,2290772,2290772
2016,NH,Natural Gas,9488872,0,9488872
2016,NH,Nuclear,0,21522326,21522326
2016,NH,Other,98002,0,98002
2016,NH,Other Biomass,249880,0,249880
2016,NH,Petroleum,77596,0,77596
2016,NH,Total,0,38564986,38564986
2016,NH,Wind,0,864648,864648
2016,NH,Wood and Wood Derived Fuels,3128856,0,3128856
2016,NJ,Coal,2629082,0,2629082
2016,NJ,Hydroelectric Conventional,0,18956,18956
2016,NJ,Natural Gas,87614907,0,87614907
2016,NJ,Nuclear,0,59770374,59770374
2016,NJ,Other,1213931,0,1213931
2016,NJ,Other Biomass,1965556,0,1965556
2016,NJ,Other Gases,414336,0,414336
2016,NJ,Petroleum,292252,0,292252
2016,NJ,Pumped Storage,0,-408026,-408026
2016,NJ,Solar Thermal and Photovoltaic,0,1669757,1669757
2016,NJ,Total,0,155222806,155222806
2016,NJ,Wind,0,41682,41682
2016,NM,Coal,36730540,0,36730540
2016,NM,Geothermal,28436,0,28436
2016,NM,Hydroelectric Conventional,0,295944,295944
2016,NM,Natural Gas,19915105,0,19915105
2016,NM,Other,558,0,558
2016,NM,Other Biomass,35626,0,35626
2016,NM,Petroleum,103366,0,103366
2016,NM,Solar Thermal and Photovoltaic,0,1503672,1503672
2016,NM,Total,0,65824090,65824090
2016,NM,Wind,0,7210842,7210842
2016,NV,Coal,4333662,0,4333662
2016,NV,Geothermal,6706798,0,6706798
2016,NV,Hydroelectric Conventional,0,3578438,3578438
2016,NV,Natural Gas,57843223,0,57843223
2016,NV,Other,42056,0,42056
2016,NV,Other Biomass,110528,0,110528
2016,NV,Other Gases,1484,0,1484
2016,NV,Petroleum,21970,0,21970
2016,NV,Solar Thermal and Photovoltaic,0,6248120,6248120
2016,NV,Total,0,79574010,79574010
2016,NV,Wind,0,687730,687730
2016,NY,Coal,3540476,0,3540476
2016,NY,Hydroelectric Conventional,0,53776468,53776468
2016,NY,Natural Gas,113586672,0,113586672
2016,NY,Nuclear,0,83141980,83141980
2016,NY,Other,1797978,0,1797978
2016,NY,Other Biomass,3209300,0,3209300
2016,NY,Other Gases,0,0,0
2016,NY,Petroleum,1285905,0,1285905
2016,NY,Pumped Storage,0,-941864,-941864
2016,NY,Solar Thermal and Photovoltaic,0,279222,279222
2016,NY,Total,0,268834214,268834214
2016,NY,Wind,0,7880360,7880360
2016,NY,Wood and Wood Derived Fuels,1277718,0,1277718
2016,OH,Coal,137550327,0,137550327
2016,OH,Hydroelectric Conventional,0,1000640,1000640
2016,OH,Natural Gas,57884794,0,57884794
2016,OH,Nuclear,0,33634772,33634772
2016,OH,Other,-96866,0,-96866
2016,OH,Other Biomass,900032,0,900032
2016,OH,Other Gases,1441991,0,1441991
2016,OH,Petroleum,2362507,0,2362507
2016,OH,Solar Thermal and Photovoltaic,0,131116,131116
2016,OH,Total,0,237844156,237844156
2016,OH,Wind,0,2490674,2490674
2016,OH,Wood and Wood Derived Fuels,544169,0,544169
2016,OK,Coal,38316089,0,38316089
2016,OK,Hydroelectric Conventional,0,5146848,5146848
2016,OK,Natural Gas,73058172,0,73058172
2016,OK,Other,55380,0,55380
2016,OK,Other Biomass,238180,0,238180
2016,OK,Petroleum,34523,0,34523
2016,OK,Pumped Storage,0,-174858,-174858
2016,OK,Solar Thermal and Photovoltaic,0,10872,10872
2016,OK,Total,0,157310014,157310014
2016,OK,Wind,0,40138178,40138178
2016,OK,Wood and Wood Derived Fuels,486632,0,486632
2016,OR,Coal,3796404,0,3796404
2016,OR,Geothermal,367400,0,367400
2016,OR,Hydroelectric Conventional,0,69098732,69098732
2016,OR,Natural Gas,30613322,0,30613322
2016,OR,Other,81234,0,81234
2016,OR,Other Biomass,718210,0,718210
2016,OR,Petroleum,9700,0,9700
2016,OR,Solar Thermal and Photovoltaic,0,81872,81872
2016,OR,Total,0,120364025,120364025
2016,OR,Wind,0,14314256,14314256
2016,OR,Wood and Wood Derived Fuels,1282894,0,1282894
2016,PA,Coal,109344060,0,109344060
2016,PA,Hydroelectric Conventional,0,4749038,4749038
2016,PA,Natural Gas,136097292,0,136097292
2016,PA,Nuclear,0,165848022,165848022
2016,PA,Other,1631613,0,1631613
2016,PA,Other Biomass,3766635,0,3766635
2016,PA,Other Gases,975250,0,975250
2016,PA,Petroleum,726448,0,726448
2016,PA,Pumped Storage,0,-1123672,-1123672
2016,PA,Solar Thermal and Photovoltaic,0,149610,149610
2016,PA,Total,0,430133018,430133018
2016,PA,Wind,0,6952492,6952492
2016,PA,Wood and Wood Derived Fuels,1016229,0,1016229
2016,RI,Coal,0,0,0
2016,RI,Hydroelectric Conventional,0,4256,4256
2016,RI,Natural Gas,12581006,0,12581006
2016,RI,Other Biomass,409552,0,409552
2016,RI,Petroleum,52566,0,52566
2016,RI,Solar Thermal and Photovoltaic,0,29326,29326
2016,RI,Total,0,13129770,13129770
2016,RI,Wind,0,53064,53064
2016,SC,Coal,42005827,0,42005827
2016,SC,Hydroelectric Conventional,0,4452148,4452148
2016,SC,Natural Gas,32733708,0,32733708
2016,SC,Nuclear,0,111651832,111651832
2016,SC,Other,90840,0,90840
2016,SC,Other Biomass,359522,0,359522
2016,SC,Petroleum,227724,0,227724
2016,SC,Pumped Storage,0,-1953200,-1953200
2016,SC,Solar Thermal and Photovoltaic,0,9942,9942
2016,SC,Total,0,193971528,193971528
2016,SC,Wood and Wood Derived Fuels,4393185,0,4393185
2016,SD,Coal,4165360,0,4165360
2016,SD,Hydroelectric Conventional,0,9611052,9611052
2016,SD,Natural Gas,1837122,0,1837122
2016,SD,Other,0,0,0
2016,SD,Other Biomass,0,0,0
2016,SD,Petroleum,5586,0,5586
2016,SD,Solar Thermal and Photovoltaic,0,728,728
2016,SD,Total,0,23048368,23048368
2016,SD,Wind,0,7428518,7428518
2016,TN,Coal,62335268,0,62335268
2016,TN,Hydroelectric Conventional,0,13548122,13548122
2016,TN,Natural Gas,22637030,0,22637030
2016,TN,Nuclear,0,59156172,59156172
2016,TN,Other,39166,0,39166
2016,TN,Other Biomass,181474,0,181474
2016,TN,Other Gases,30776,0,30776
2016,TN,Petroleum,243162,0,243162
2016,TN,Pumped Storage,0,-1407892,-1407892
2016,TN,Solar Thermal and Photovoltaic,0,157234,157234
2016,TN,Total,0,158681266,158681266
2016,TN,Wind,0,75494,75494
2016,TN,Wood and Wood Derived Fuels,1685260,0,1685260
2016,TX,Coal,242461864,0,242461864
2016,TX,Hydroelectric Conventional,0,2684010,2684010
2016,TX,Natural Gas,451952521,0,451952521
2016,TX,Nuclear,0,84158890,84158890
2016,TX,Other,1528986,0,1528986
2016,TX,Other Biomass,1470085,0,1470085
2016,TX,Other Gases,5027487,0,5027487
2016,TX,Petroleum,392844,0,392844
2016,TX,Solar Thermal and Photovoltaic,0,1461620,1461620
2016,TX,Total,0,908095182,908095182
2016,TX,Wind,0,115061568,115061568
2016,TX,Wood and Wood Derived Fuels,1895306,0,1895306
2016,UT,Coal,51878886,0,51878886
2016,UT,Geothermal,970188,0,970188
2016,UT,Hydroelectric Conventional,0,1519084,1519084
2016,UT,Natural Gas,17382639,0,17382639
2016,UT,Other,425702,0,425702
2016,UT,Other Biomass,168168,0,168168
2016,UT,Other Gases,108198,0,108198
2016,UT,Petroleum,63104,0,63104
2016,UT,Solar Thermal and Photovoltaic,0,2107322,2107322
2016,UT,Total,0,76267856,76267856
2016,UT,Wind,0,1644564,1644564
2016,VA,Coal,32998824,0,32998824
2016,VA,Hydroelectric Conventional,0,2942924,2942924
2016,VA,Natural Gas,81809686,0,81809686
2016,VA,Nuclear,0,59463790,59463790
2016,VA,Other,923652,0,923652
2016,VA,Other Biomass,2211611,0,2211611
2016,VA,Petroleum,1070838,0,1070838
2016,VA,Pumped Storage,0,-2325272,-2325272
2016,VA,Solar Thermal and Photovoltaic,0,41816,41816
2016,VA,Total,0,185109752,185109752
2016,VA,Wood and Wood Derived Fuels,5971882,0,5971882
2016,VT,Hydroelectric Conventional,0,2155034,2155034
2016,VT,Natural Gas,3931,0,3931
2016,VT,Other,0,0,0
2016,VT,Other Biomass,31262,0,31262
2016,VT,Petroleum,8034,0,8034
2016,VT,Solar Thermal and Photovoltaic,0,118062,118062
2016,VT,Total,0,3822414,3822414
2016,VT,Wind,0,582364,582364
2016,VT,Wood and Wood Derived Fuels,923727,0,923727
2016,WA,Coal,9203452,0,9203452
2016,WA,Hydroelectric Conventional,0,156691618,156691618
2016,WA,Natural Gas,21964391,0,21964391
2016,WA,Nuclear,0,19251244,19251244
2016,WA,Other,119502,0,119502
2016,WA,Other Biomass,598644,0,598644
2016,WA,Other Gases,803284,0,803284
2016,WA,Petroleum,44036,0,44036
2016,WA,Pumped Storage,0,-4636,-4636
2016,WA,Solar Thermal and Photovoltaic,0,1454,1454
2016,WA,Total,0,228173165,228173165
2016,WA,Wind,0,16083694,16083694
2016,WA,Wood and Wood Derived Fuels,3416480,0,3416480
2016,WI,Coal,66725682,0,66725682
2016,WI,Hydroelectric Conventional,0,5590516,5590516
2016,WI,Natural Gas,30945519,0,30945519
2016,WI,Nuclear,0,20302788,20302788
2016,WI,Other,99032,0,99032
2016,WI,Other Biomass,1180304,0,1180304
2016,WI,Petroleum,294221,0,294221
2016,WI,Solar Thermal and Photovoltaic,0,5342,5342
2016,WI,Total,0,129933222,129933222
2016,WI,Wind,0,3030522,3030522
2016,WI,Wood and Wood Derived Fuels,1759297,0,1759297
2016,WV,Coal,143025922,0,143025922
2016,WV,Hydroelectric Conventional,0,3276494,3276494
2016,WV,Natural Gas,2449134,0,2449134
2016,WV,Other,-24562,0,-24562
2016,WV,Other Gases,49302,0,49302
2016,WV,Petroleum,245338,0,245338
2016,WV,Total,0,151885936,151885936
2016,WV,Wind,0,2864308,2864308
2016,WY,Coal,80053748,0,80053748
2016,WY,Hydroelectric Conventional,0,1946976,1946976
2016,WY,Natural Gas,1576286,0,1576286
2016,WY,Other,130028,0,130028
2016,WY,Other Gases,716276,0,716276
2016,WY,Petroleum,111271,0,111271
2016,WY,Total,0,93313260,93313260
2016,WY,Wind,0,8778676,8778676
2017,AK,Coal,1111414,0,1111414
2017,AK,Hydroelectric Conventional,0,3287340,3287340
2017,AK,Natural Gas,6469736,0,6469736
2017,AK,Other,-5422,0,-5422
2017,AK,Other Biomass,87124,0,87124
2017,AK,Petroleum,1761365,0,1761365
2017,AK,Total,0,12994932,12994932
2017,AK,Wind,0,283374,283374
2017,AK,Wood and Wood Derived Fuels,0,0,0
2017,AL,Coal,62880802,0,62880802
2017,AL,Hydroelectric Conventional,0,18474646,18474646
2017,AL,Natural Gas,105967325,0,105967325
2017,AL,Nuclear,0,85303946,85303946
2017,AL,Other,8,0,8
2017,AL,Other Biomass,82704,0,82704
2017,AL,Other Gases,17660,0,17660
2017,AL,Petroleum,71416,0,71416
2017,AL,Solar Thermal and Photovoltaic,0,361376,361376
2017,AL,Total,0,279928500,279928500
2017,AL,Wood and Wood Derived Fuels,6768615,0,6768615
2017,AR,Coal,52570870,0,52570870
2017,AR,Hydroelectric Conventional,0,5886618,5886618
2017,AR,Natural Gas,34628740,0,34628740
2017,AR,Nuclear,0,25382158,25382158
2017,AR,Other,8166,0,8166
2017,AR,Other Biomass,210202,0,210202
2017,AR,Petroleum,97958,0,97958
2017,AR,Pumped Storage,0,40972,40972
2017,AR,Solar Thermal and Photovoltaic,0,61624,61624
2017,AR,Total,0,121550432,121550432
2017,AR,Wood and Wood Derived Fuels,2663128,0,2663128
2017,AZ,Coal,62792276,0,62792276
2017,AZ,Hydroelectric Conventional,0,13663782,13663782
2017,AZ,Natural Gas,59181398,0,59181398
2017,AZ,Nuclear,0,64680276,64680276
2017,AZ,Other,-2372,0,-2372
2017,AZ,Other Biomass,77460,0,77460
2017,AZ,Petroleum,113458,0,113458
2017,AZ,Pumped Storage,0,-91660,-91660
2017,AZ,Solar Thermal and Photovoltaic,0,9884002,9884002
2017,AZ,Total,0,211703530,211703530
2017,AZ,Wind,0,1139868,1139868
2017,AZ,Wood and Wood Derived Fuels,265042,0,265042
2017,CA,Coal,582184,0,582184
2017,CA,Geothermal,23119200,0,23119200
2017,CA,Hydroelectric Conventional,0,84726282,84726282
2017,CA,Natural Gas,176700317,0,176700317
2017,CA,Nuclear,0,35802158,35802158
2017,CA,Other,1671074,0,1671074
2017,CA,Other Biomass,5681994,0,5681994
2017,CA,Other Gases,2816670,0,2816670
2017,CA,Petroleum,91592,0,91592
2017,CA,Pumped Storage,0,814908,814908
2017,CA,Solar Thermal and Photovoltaic,0,48705833,48705833
2017,CA,Total,0,412293040,412293040
2017,CA,Wind,0,25645896,25645896
2017,CA,Wood and Wood Derived Fuels,5934930,0,5934930
2017,CO,Coal,58484433,0,58484433
2017,CO,Hydroelectric Conventional,0,3794456,3794456
2017,CO,Natural Gas,25064485,0,25064485
2017,CO,Other,113422,0,113422
2017,CO,Other Biomass,149704,0,149704
2017,CO,Petroleum,14498,0,14498
2017,CO,Pumped Storage,0,-653304,-653304
2017,CO,Solar Thermal and Photovoltaic,0,1908996,1908996
2017,CO,Total,0,107688004,107688004
2017,CO,Wind,0,18629326,18629326
2017,CO,Wood and Wood Derived Fuels,181988,0,181988
2017,CT,Coal,395018,0,395018
2017,CT,Hydroelectric Conventional,0,664374,664374
2017,CT,Natural Gas,31922514,0,31922514
2017,CT,Nuclear,0,32999242,32999242
2017,CT,Other,1093772,0,1093772
2017,CT,Other Biomass,1168626,0,1168626
2017,CT,Petroleum,356874,0,356874
2017,CT,Pumped Storage,0,3594,3594
2017,CT,Solar Thermal and Photovoltaic,0,79732,79732
2017,CT,Total,0,69125308,69125308
2017,CT,Wind,0,25412,25412
2017,CT,Wood and Wood Derived Fuels,416150,0,416150
2017,DC,Natural Gas,39408,0,39408
2017,DC,Other Biomass,94334,0,94334
2017,DC,Petroleum,0,0,0
2017,DC,Total,0,133742,133742
2017,DE,Coal,717594,0,717594
2017,DE,Natural Gas,13446377,0,13446377
2017,DE,Other Biomass,125630,0,125630
2017,DE,Other Gases,541026,0,541026
2017,DE,Petroleum,50825,0,50825
2017,DE,Solar Thermal and Photovoltaic,0,100570,100570
2017,DE,Total,0,14991953,14991953
2017,DE,Wind,0,9930,9930
2017,FL,Coal,75025524,0,75025524
2017,FL,Hydroelectric Conventional,0,436598,436598
2017,FL,Natural Gas,322209176,0,322209176
2017,FL,Nuclear,0,58292438,58292438
2017,FL,Other,6156318,0,6156318
2017,FL,Other Biomass,5569757,0,5569757
2017,FL,Other Gases,9808,0,9808
2017,FL,Petroleum,2925769,0,2925769
2017,FL,Solar Thermal and Photovoltaic,0,1752854,1752854
2017,FL,Total,0,476826874,476826874
2017,FL,Wood and Wood Derived Fuels,4448629,0,4448629
2017,GA,Coal,64974116,0,64974116
2017,GA,Hydroelectric Conventional,0,4819498,4819498
2017,GA,Natural Gas,105445000,0,105445000
2017,GA,Nuclear,0,67417610,67417610
2017,GA,Other,174790,0,174790
2017,GA,Other Biomass,705456,0,705456
2017,GA,Petroleum,565556,0,565556
2017,GA,Pumped Storage,0,-2495158,-2495158
2017,GA,Solar Thermal and Photovoltaic,0,3972544,3972544
2017,GA,Total,0,254910628,254910628
2017,GA,Wood and Wood Derived Fuels,9331216,0,9331216
2017,HI,Coal,2751448,0,2751448
2017,HI,Geothermal,645184,0,645184
2017,HI,Hydroelectric Conventional,0,132150,132150
2017,HI,Other,726246,0,726246
2017,HI,Other Biomass,585524,0,585524
2017,HI,Other Gases,104044,0,104044
2017,HI,Petroleum,13267191,0,13267191
2017,HI,Solar Thermal and Photovoltaic,0,350038,350038
2017,HI,Total,0,19625936,19625936
2017,HI,Wind,0,1064110,1064110
2017,IA,Coal,50716459,0,50716459
2017,IA,Hydroelectric Conventional,0,2067880,2067880
2017,IA,Natural Gas,9134894,0,9134894
2017,IA,Nuclear,0,10427018,10427018
2017,IA,Other,4764,0,4764
2017,IA,Other Biomass,415717,0,415717
2017,IA,Petroleum,293438,0,293438
2017,IA,Solar Thermal and Photovoltaic,0,9676,9676
2017,IA,Total,0,115819132,115819132
2017,IA,Wind,0,42745504,42745504
2017,IA,Wood and Wood Derived Fuels,3780,0,3780
2017,ID,Coal,47674,0,47674
2017,ID,Geothermal,168872,0,168872
2017,ID,Hydroelectric Conventional,0,21340818,21340818
2017,ID,Natural Gas,6158814,0,6158814
2017,ID,Other,136686,0,136686
2017,ID,Other Biomass,233510,0,233510
2017,ID,Petroleum,340,0,340
2017,ID,Solar Thermal and Photovoltaic,0,918690,918690
2017,ID,Total,0,34792048,34792048
2017,ID,Wind,0,5089350,5089350
2017,ID,Wood and Wood Derived Fuels,697294,0,697294
2017,IL,Coal,115960573,0,115960573
2017,IL,Hydroelectric Conventional,0,250262,250262
2017,IL,Natural Gas,30032420,0,30032420
2017,IL,Nuclear,0,194382284,194382284
2017,IL,Other,507174,0,507174
2017,IL,Other Biomass,948116,0,948116
2017,IL,Other Gases,360196,0,360196
2017,IL,Petroleum,102291,0,102291
2017,IL,Solar Thermal and Photovoltaic,0,104294,104294
2017,IL,Total,0,367183143,367183143
2017,IL,Wind,0,24535532,24535532
2017,IL,Wood and Wood Derived Fuels,0,0,0
2017,IN,Coal,144769914,0,144769914
2017,IN,Hydroelectric Conventional,0,612160,612160
2017,IN,Natural Gas,35951833,0,35951833
2017,IN,Other,612152,0,612152
2017,IN,Other Biomass,946806,0,946806
2017,IN,Other Gases,3981998,0,3981998
2017,IN,Petroleum,250647,0,250647
2017,IN,Solar Thermal and Photovoltaic,0,555350,555350
2017,IN,Total,0,197859636,197859636
2017,IN,Wind,0,10178780,10178780
2017,IN,Wood and Wood Derived Fuels,0,0,0
2017,KS,Coal,38779542,0,38779542
2017,KS,Hydroelectric Conventional,0,58436,58436
2017,KS,Natural Gas,4293110,0,4293110
2017,KS,Nuclear,0,21295974,21295974
2017,KS,Other,9464,0,9464
2017,KS,Other Biomass,114326,0,114326
2017,KS,Petroleum,109036,0,109036
2017,KS,Solar Thermal and Photovoltaic,0,10560,10560
2017,KS,Total,0,101866593,101866593
2017,KS,Wind,0,37196146,37196146
2017,KY,Coal,114473018,0,114473018
2017,KY,Hydroelectric Conventional,0,9012036,9012036
2017,KY,Natural Gas,20759257,0,20759257
2017,KY,Other,89390,0,89390
2017,KY,Other Biomass,228974,0,228974
2017,KY,Petroleum,995540,0,995540
2017,KY,Solar Thermal and Photovoltaic,0,39770,39770
2017,KY,Total,0,146358392,146358392
2017,KY,Wood and Wood Derived Fuels,760406,0,760406
2017,LA,Coal,24631850,0,24631850
2017,LA,Hydroelectric Conventional,0,1812474,1812474
2017,LA,Natural Gas,118002184,0,118002184
2017,LA,Nuclear,0,30819490,30819490
2017,LA,Other,1264700,0,1264700
2017,LA,Other Biomass,175568,0,175568
2017,LA,Other Gases,4286130,0,4286130
2017,LA,Petroleum,9139506,0,9139506
2017,LA,Solar Thermal and Photovoltaic,0,4846,4846
2017,LA,Total,0,195438425,195438425
2017,LA,Wood and Wood Derived Fuels,5301678,0,5301678
2017,MA,Coal,2272636,0,2272636
2017,MA,Hydroelectric Conventional,0,2074982,2074982
2017,MA,Natural Gas,44305116,0,44305116
2017,MA,Nuclear,0,10094340,10094340
2017,MA,Other,1653168,0,1653168
2017,MA,Other Biomass,2059177,0,2059177
2017,MA,Petroleum,531015,0,531015
2017,MA,Pumped Storage,0,-886024,-886024
2017,MA,Solar Thermal and Photovoltaic,0,1576949,1576949
2017,MA,Total,0,64408231,64408231
2017,MA,Wind,0,465245,465245
2017,MA,Wood and Wood Derived Fuels,261626,0,261626
2017,MD,Coal,17028018,0,17028018
2017,MD,Hydroelectric Conventional,0,3930918,3930918
2017,MD,Natural Gas,13458079,0,13458079
2017,MD,Nuclear,0,30213976,30213976
2017,MD,Other,643424,0,643424
2017,MD,Other Biomass,831880,0,831880
2017,MD,Petroleum,204314,0,204314
2017,MD,Solar Thermal and Photovoltaic,0,534180,534180
2017,MD,Total,0,68208160,68208160
2017,MD,Wind,0,1122698,1122698
2017,MD,Wood and Wood Derived Fuels,240676,0,240676
2017,ME,Coal,135870,0,135870
2017,ME,Hydroelectric Conventional,0,6777554,6777554
2017,ME,Natural Gas,4474136,0,4474136
2017,ME,Other,792587,0,792587
2017,ME,Other Biomass,349198,0,349198
2017,ME,Petroleum,264782,0,264782
2017,ME,Solar Thermal and Photovoltaic,0,10872,10872
2017,ME,Total,0,22528560,22528560
2017,ME,Wind,0,4665706,4665706
2017,ME,Wood and Wood Derived Fuels,5057854,0,5057854
2017,MI,Coal,84041097,0,84041097
2017,MI,Hydroelectric Conventional,0,3357914,3357914
2017,MI,Natural Gas,52261317,0,52261317
2017,MI,Nuclear,0,64762384,64762384
2017,MI,Other,519067,0,519067
2017,MI,Other Biomass,1971710,0,1971710
2017,MI,Other Gases,3304333,0,3304333
2017,MI,Petroleum,2233022,0,2233022
2017,MI,Pumped Storage,0,-1349518,-1349518
2017,MI,Solar Thermal and Photovoltaic,0,126608,126608
2017,MI,Total,0,224627002,224627002
2017,MI,Wind,0,10382546,10382546
2017,MI,Wood and Wood Derived Fuels,3016525,0,3016525
2017,MN,Coal,45563796,0,45563796
2017,MN,Hydroelectric Conventional,0,2515405,2515405
2017,MN,Natural Gas,13415184,0,13415184
2017,MN,Nuclear,0,27808702,27808702
2017,MN,Other,791532,0,791532
2017,MN,Other Biomass,1273786,0,1273786
2017,MN,Petroleum,70305,0,70305
2017,MN,Solar Thermal and Photovoltaic,0,1192248,1192248
2017,MN,Total,0,117497662,117497662
2017,MN,Wind,0,22274544,22274544
2017,MN,Wood and Wood Derived Fuels,2592165,0,2592165
2017,MO,Coal,135037885,0,135037885
2017,MO,Hydroelectric Conventional,0,2363160,2363160
2017,MO,Natural Gas,10410570,0,10410570
2017,MO,Nuclear,0,16608254,16608254
2017,MO,Other,7294,0,7294
2017,MO,Other Biomass,175671,0,175671
2017,MO,Petroleum,121440,0,121440
2017,MO,Pumped Storage,0,199448,199448
2017,MO,Solar Thermal and Photovoltaic,0,112376,112376
2017,MO,Total,0,169213461,169213461
2017,MO,Wind,0,4064636,4064636
2017,MO,Wood and Wood Derived Fuels,112728,0,112728
2017,MS,Coal,9256460,0,9256460
2017,MS,Natural Gas,92316946,0,92316946
2017,MS,Nuclear,0,14729296,14729296
2017,MS,Other,3710,0,3710
2017,MS,Other Biomass,30450,0,30450
2017,MS,Petroleum,22920,0,22920
2017,MS,Solar Thermal and Photovoltaic,0,171846,171846
2017,MS,Total,0,119455274,119455274
2017,MS,Wood and Wood Derived Fuels,2923646,0,2923646
2017,MT,Coal,27728199,0,27728199
2017,MT,Hydroelectric Conventional,0,21892922,21892922
2017,MT,Natural Gas,833042,0,833042
2017,MT,Other,663668,0,663668
2017,MT,Other Gases,27480,0,27480
2017,MT,Petroleum,917306,0,917306
2017,MT,Solar Thermal and Photovoltaic,0,27266,27266
2017,MT,Total,0,56441892,56441892
2017,MT,Wind,0,4309646,4309646
2017,MT,Wood and Wood Derived Fuels,42364,0,42364
2017,NC,Coal,68920333,0,68920333
2017,NC,Hydroelectric Conventional,0,7636034,7636034
2017,NC,Natural Gas,77179589,0,77179589
2017,NC,Nuclear,0,84748528,84748528
2017,NC,Other,1154760,0,1154760
2017,NC,Other Biomass,1389658,0,1389658
2017,NC,Petroleum,502763,0,502763
2017,NC,Pumped Storage,0,0,0
2017,NC,Solar Thermal and Photovoltaic,0,10228236,10228236
2017,NC,Total,0,256936234,256936234
2017,NC,Wind,0,941486,941486
2017,NC,Wood and Wood Derived Fuels,4234849,0,4234849
2017,ND,Coal,53512930,0,53512930
2017,ND,Hydroelectric Conventional,0,5164214,5164214
2017,ND,Natural Gas,1352062,0,1352062
2017,ND,Other,102606,0,102606
2017,ND,Other Biomass,3992,0,3992
2017,ND,Other Gases,84424,0,84424
2017,ND,Petroleum,71454,0,71454
2017,ND,Total,0,83010148,83010148
2017,ND,Wind,0,22718466,22718466
2017,NE,Coal,42347126,0,42347126
2017,NE,Hydroelectric Conventional,0,2978116,2978116
2017,NE,Natural Gas,1258707,0,1258707
2017,NE,Nuclear,0,13825474,13825474
2017,NE,Other,0,0,0
2017,NE,Other Biomass,194574,0,194574
2017,NE,Petroleum,11282,0,11282
2017,NE,Solar Thermal and Photovoltaic,0,30516,30516
2017,NE,Total,0,70813964,70813964
2017,NE,Wind,0,10168168,10168168
2017,NE,Wood and Wood Derived Fuels,0,0,0
2017,NH,Coal,574562,0,574562
2017,NH,Hydroelectric Conventional,0,2826804,2826804
2017,NH,Natural Gas,7160206,0,7160206
2017,NH,Nuclear,0,19981408,19981408
2017,NH,Other,97368,0,97368
2017,NH,Other Biomass,276055,0,276055
2017,NH,Petroleum,209792,0,209792
2017,NH,Total,0,34893682,34893682
2017,NH,Wind,0,823184,823184
2017,NH,Wood and Wood Derived Fuels,2944304,0,2944304
2017,NJ,Coal,2432182,0,2432182
2017,NJ,Hydroelectric Conventional,0,27266,27266
2017,NJ,Natural Gas,75415696,0,75415696
2017,NJ,Nuclear,0,68065396,68065396
2017,NJ,Other,1165970,0,1165970
2017,NJ,Other Biomass,1857554,0,1857554
2017,NJ,Other Gases,438984,0,438984
2017,NJ,Petroleum,312728,0,312728
2017,NJ,Pumped Storage,0,-323638,-323638
2017,NJ,Solar Thermal and Photovoltaic,0,1851995,1851995
2017,NJ,Total,0,151289026,151289026
2017,NJ,Wind,0,44894,44894
2017,NM,Coal,36828966,0,36828966
2017,NM,Geothermal,25926,0,25926
2017,NM,Hydroelectric Conventional,0,386498,386498
2017,NM,Natural Gas,18263310,0,18263310
2017,NM,Other,-1174,0,-1174
2017,NM,Other Biomass,35176,0,35176
2017,NM,Petroleum,81700,0,81700
2017,NM,Solar Thermal and Photovoltaic,0,2385282,2385282
2017,NM,Total,0,67194826,67194826
2017,NM,Wind,0,9189142,9189142
2017,NV,Coal,3731184,0,3731184
2017,NV,Geothermal,6583748,0,6583748
2017,NV,Hydroelectric Conventional,0,3625400,3625400
2017,NV,Natural Gas,53251808,0,53251808
2017,NV,Other,63132,0,63132
2017,NV,Other Biomass,115362,0,115362
2017,NV,Other Gases,0,0,0
2017,NV,Petroleum,17492,0,17492
2017,NV,Solar Thermal and Photovoltaic,0,8291734,8291734
2017,NV,Total,0,76402588,76402588
2017,NV,Wind,0,722728,722728
2017,NY,Coal,1540592,0,1540592
2017,NY,Hydroelectric Conventional,0,60289864,60289864
2017,NY,Natural Gas,94543513,0,94543513
2017,NY,Nuclear,0,84334818,84334818
2017,NY,Other,1847412,0,1847412
2017,NY,Other Biomass,3332102,0,3332102
2017,NY,Other Gases,0,0,0
2017,NY,Petroleum,1195786,0,1195786
2017,NY,Pumped Storage,0,-831342,-831342
2017,NY,Solar Thermal and Photovoltaic,0,365608,365608
2017,NY,Total,0,256130165,256130165
2017,NY,Wind,0,8271902,8271902
2017,NY,Wood and Wood Derived Fuels,1239910,0,1239910
2017,OH,Coal,136687273,0,136687273
2017,OH,Hydroelectric Conventional,0,554698,554698
2017,OH,Natural Gas,57599023,0,57599023
2017,OH,Nuclear,0,35375578,35375578
2017,OH,Other,-3078,0,-3078
2017,OH,Other Biomass,938274,0,938274
2017,OH,Other Gases,1571701,0,1571701
2017,OH,Petroleum,2482212,0,2482212
2017,OH,Solar Thermal and Photovoltaic,0,210356,210356
2017,OH,Total,0,239108732,239108732
2017,OH,Wind,0,3177120,3177120
2017,OH,Wood and Wood Derived Fuels,515574,0,515574
2017,OK,Coal,34735708,0,34735708
2017,OK,Hydroelectric Conventional,0,4072400,4072400
2017,OK,Natural Gas,60901138,0,60901138
2017,OK,Other,96833,0,96833
2017,OK,Other Biomass,135854,0,135854
2017,OK,Petroleum,32109,0,32109
2017,OK,Pumped Storage,0,-235220,-235220
2017,OK,Solar Thermal and Photovoltaic,0,65164,65164
2017,OK,Total,0,147463308,147463308
2017,OK,Wind,0,47197686,47197686
2017,OK,Wood and Wood Derived Fuels,461636,0,461636
2017,OR,Coal,3456210,0,3456210
2017,OR,Geothermal,348762,0,348762
2017,OR,Hydroelectric Conventional,0,76587876,76587876
2017,OR,Natural Gas,30132757,0,30132757
2017,OR,Other,78492,0,78492
2017,OR,Other Biomass,722658,0,722658
2017,OR,Petroleum,20788,0,20788
2017,OR,Solar Thermal and Photovoltaic,0,388104,388104
2017,OR,Total,0,125427494,125427494
2017,OR,Wind,0,12453186,12453186
2017,OR,Wood and Wood Derived Fuels,1238662,0,1238662
2017,PA,Coal,95268542,0,95268542
2017,PA,Hydroelectric Conventional,0,6246632,6246632
2017,PA,Natural Gas,145006895,0,145006895
2017,PA,Nuclear,0,166399664,166399664
2017,PA,Other,1767787,0,1767787
2017,PA,Other Biomass,3831534,0,3831534
2017,PA,Other Gases,892156,0,892156
2017,PA,Petroleum,710837,0,710837
2017,PA,Pumped Storage,0,-1210588,-1210588
2017,PA,Solar Thermal and Photovoltaic,0,139233,139233
2017,PA,Total,0,427278598,427278598
2017,PA,Wind,0,7181130,7181130
2017,PA,Wood and Wood Derived Fuels,1044776,0,1044776
2017,RI,Coal,0,0,0
2017,RI,Hydroelectric Conventional,0,4744,4744
2017,RI,Natural Gas,14376384,0,14376384
2017,RI,Other Biomass,405968,0,405968
2017,RI,Petroleum,116816,0,116816
2017,RI,Solar Thermal and Photovoltaic,0,28166,28166
2017,RI,Total,0,15229882,15229882
2017,RI,Wind,0,297804,297804
2017,SC,Coal,36303489,0,36303489
2017,SC,Hydroelectric Conventional,0,3670078,3670078
2017,SC,Natural Gas,34312678,0,34312678
2017,SC,Nuclear,0,108689108,108689108
2017,SC,Other,82425,0,82425
2017,SC,Other Biomass,342896,0,342896
2017,SC,Petroleum,195302,0,195302
2017,SC,Pumped Storage,0,-2049658,-2049658
2017,SC,Solar Thermal and Photovoltaic,0,159044,159044
2017,SC,Total,0,186161879,186161879
2017,SC,Wood and Wood Derived Fuels,4456515,0,4456515
2017,SD,Coal,4124924,0,4124924
2017,SD,Hydroelectric Conventional,0,10511040,10511040
2017,SD,Natural Gas,1308696,0,1308696
2017,SD,Other Biomass,0,0,0
2017,SD,Petroleum,6062,0,6062
2017,SD,Solar Thermal and Photovoltaic,0,4112,4112
2017,SD,Total,0,21871438,21871438
2017,SD,Wind,0,5916604,5916604
2017,TN,Coal,55430568,0,55430568
2017,TN,Hydroelectric Conventional,0,17382268,17382268
2017,TN,Natural Gas,20536722,0,20536722
2017,TN,Nuclear,0,63635004,63635004
2017,TN,Other,42880,0,42880
2017,TN,Other Biomass,193030,0,193030
2017,TN,Other Gases,23296,0,23296
2017,TN,Petroleum,247326,0,247326
2017,TN,Pumped Storage,0,-1372308,-1372308
2017,TN,Solar Thermal and Photovoltaic,0,184684,184684
2017,TN,Total,0,158092444,158092444
2017,TN,Wind,0,86654,86654
2017,TN,Wood and Wood Derived Fuels,1702320,0,1702320
2017,TX,Coal,269296716,0,269296716
2017,TX,Hydroelectric Conventional,0,2123994,2123994
2017,TX,Natural Gas,409023992,0,409023992
2017,TX,Nuclear,0,77162802,77162802
2017,TX,Other,1055698,0,1055698
2017,TX,Other Biomass,1337214,0,1337214
2017,TX,Other Gases,4943933,0,4943933
2017,TX,Petroleum,327422,0,327422
2017,TX,Solar Thermal and Photovoltaic,0,4378254,4378254
2017,TX,Total,0,905588730,905588730
2017,TX,Wind,0,134121994,134121994
2017,TX,Wood and Wood Derived Fuels,1816714,0,1816714
2017,UT,Coal,52779134,0,52779134
2017,UT,Geothermal,961856,0,961856
2017,UT,Hydroelectric Conventional,0,2587430,2587430
2017,UT,Natural Gas,11741704,0,11741704
2017,UT,Other,349932,0,349932
2017,UT,Other Biomass,155338,0,155338
2017,UT,Other Gases,32818,0,32818
2017,UT,Petroleum,76826,0,76826
2017,UT,Solar Thermal and Photovoltaic,0,4422210,4422210
2017,UT,Total,0,74823752,74823752
2017,UT,Wind,0,1716504,1716504
2017,VA,Coal,21452845,0,21452845
2017,VA,Hydroelectric Conventional,0,2232710,2232710
2017,VA,Natural Gas,89013771,0,89013771
2017,VA,Nuclear,0,61107468,61107468
2017,VA,Other,426644,0,426644
2017,VA,Other Biomass,1814808,0,1814808
2017,VA,Petroleum,912250,0,912250
2017,VA,Pumped Storage,0,-2555590,-2555590
2017,VA,Solar Thermal and Photovoltaic,0,626442,626442
2017,VA,Total,0,180834298,180834298
2017,VA,Wood and Wood Derived Fuels,5802950,0,5802950
2017,VT,Hydroelectric Conventional,0,2560736,2560736
2017,VT,Natural Gas,3614,0,3614
2017,VT,Other,0,0,0
2017,VT,Other Biomass,23764,0,23764
2017,VT,Petroleum,14266,0,14266
2017,VT,Solar Thermal and Photovoltaic,0,197602,197602
2017,VT,Total,0,4282776,4282776
2017,VT,Wind,0,610812,610812
2017,VT,Wood and Wood Derived Fuels,871982,0,871982
2017,WA,Coal,10979008,0,10979008
2017,WA,Hydroelectric Conventional,0,164365710,164365710
2017,WA,Natural Gas,21698538,0,21698538
2017,WA,Nuclear,0,16256518,16256518
2017,WA,Other,111884,0,111884
2017,WA,Other Biomass,655946,0,655946
2017,WA,Other Gases,711850,0,711850
2017,WA,Petroleum,46234,0,46234
2017,WA,Pumped Storage,0,5990,5990
2017,WA,Solar Thermal and Photovoltaic,0,962,962
2017,WA,Total,0,231824156,231824156
2017,WA,Wind,0,13850310,13850310
2017,WA,Wood and Wood Derived Fuels,3141208,0,3141208
2017,WI,Coal,71704445,0,71704445
2017,WI,Hydroelectric Conventional,0,5314453,5314453
2017,WI,Natural Gas,27311370,0,27311370
2017,WI,Nuclear,0,19297958,19297958
2017,WI,Other,53518,0,53518
2017,WI,Other Biomass,1164624,0,1164624
2017,WI,Petroleum,288791,0,288791
2017,WI,Solar Thermal and Photovoltaic,0,42930,42930
2017,WI,Total,0,130214666,130214666
2017,WI,Wind,0,3281374,3281374
2017,WI,Wood and Wood Derived Fuels,1755202,0,1755202
2017,WV,Coal,136698018,0,136698018
2017,WV,Hydroelectric Conventional,0,3316984,3316984
2017,WV,Natural Gas,3053456,0,3053456
2017,WV,Other,-27492,0,-27492
2017,WV,Other Gases,68952,0,68952
2017,WV,Petroleum,239559,0,239559
2017,WV,Total,0,146714160,146714160
2017,WV,Wind,0,3364682,3364682
2017,WY,Coal,80137133,0,80137133
2017,WY,Hydroelectric Conventional,0,2247248,2247248
2017,WY,Natural Gas,1557978,0,1557978
2017,WY,Other,91860,0,91860
2017,WY,Other Gases,720472,0,720472
2017,WY,Petroleum,87693,0,87693
2017,WY,Total,0,93483692,93483692
2017,WY,Wind,0,8641310,8641310
2018,AK,Coal,1257128,0,1257128
2018,AK,Hydroelectric Conventional,0,3328450,3328450
2018,AK,Natural Gas,5895805,0,5895805
2018,AK,Other,-6200,0,-6200
2018,AK,Other Biomass,90948,0,90948
2018,AK,Petroleum,1618557,0,1618557
2018,AK,Total,0,12494718,12494718
2018,AK,Wind,0,310030,310030
2018,AK,Wood and Wood Derived Fuels,0,0,0
2018,AL,Coal,63555040,0,63555040
2018,AL,Hydroelectric Conventional,0,22286278,22286278
2018,AL,Natural Gas,117600839,0,117600839
2018,AL,Nuclear,0,78925654,78925654
2018,AL,Other,-98,0,-98
2018,AL,Other Biomass,75344,0,75344
2018,AL,Other Gases,9608,0,9608
2018,AL,Petroleum,131407,0,131407
2018,AL,Solar Thermal and Photovoltaic,0,714504,714504
2018,AL,Total,0,290115988,290115988
2018,AL,Wood and Wood Derived Fuels,6817414,0,6817414
2018,AR,Coal,59992202,0,59992202
2018,AR,Hydroelectric Conventional,0,6017550,6017550
2018,AR,Natural Gas,41247410,0,41247410
2018,AR,Nuclear,0,25441636,25441636
2018,AR,Other,10174,0,10174
2018,AR,Other Biomass,149900,0,149900
2018,AR,Petroleum,71034,0,71034
2018,AR,Pumped Storage,0,80490,80490
2018,AR,Solar Thermal and Photovoltaic,0,406826,406826
2018,AR,Total,0,135998704,135998704
2018,AR,Wood and Wood Derived Fuels,2581480,0,2581480
2018,AZ,Coal,61489246,0,61489246
2018,AZ,Hydroelectric Conventional,0,13964484,13964484
2018,AZ,Natural Gas,74336150,0,74336150
2018,AZ,Nuclear,0,62194518,62194518
2018,AZ,Other,-5072,0,-5072
2018,AZ,Other Biomass,74750,0,74750
2018,AZ,Petroleum,99892,0,99892
2018,AZ,Pumped Storage,0,-9052,-9052
2018,AZ,Solar Thermal and Photovoltaic,0,10280753,10280753
2018,AZ,Total,0,223850289,223850289
2018,AZ,Wind,0,1060380,1060380
2018,AZ,Wood and Wood Derived Fuels,364240,0,364240
2018,CA,Coal,562656,0,562656
2018,CA,Geothermal,23353682,0,23353682
2018,CA,Hydroelectric Conventional,0,52661333,52661333
2018,CA,Natural Gas,179208948,0,179208948
2018,CA,Nuclear,0,36427038,36427038
2018,CA,Other,1657536,0,1657536
2018,CA,Other Biomass,5647697,0,5647697
2018,CA,Other Gases,2907920,0,2907920
2018,CA,Petroleum,137756,0,137756
2018,CA,Pumped Storage,0,-297148,-297148
2018,CA,Solar Thermal and Photovoltaic,0,53970354,53970354
2018,CA,Total,0,390530816,390530816
2018,CA,Wind,0,28047902,28047902
2018,CA,Wood and Wood Derived Fuels,6245143,0,6245143
2018,CO,Coal,52764120,0,52764120
2018,CO,Hydroelectric Conventional,0,3650770,3650770
2018,CO,Natural Gas,32796879,0,32796879
2018,CO,Other,118584,0,118584
2018,CO,Other Biomass,151576,0,151576
2018,CO,Petroleum,23764,0,23764
2018,CO,Pumped Storage,0,-525476,-525476
2018,CO,Solar Thermal and Photovoltaic,0,2124760,2124760
2018,CO,Total,0,110772557,110772557
2018,CO,Wind,0,19490300,19490300
2018,CO,Wood and Wood Derived Fuels,177278,0,177278
2018,CT,Coal,659402,0,659402
2018,CT,Hydroelectric Conventional,0,1110638,1110638
2018,CT,Natural Gas,40012915,0,40012915
2018,CT,Nuclear,0,33762984,33762984
2018,CT,Other,929466,0,929466
2018,CT,Other Biomass,989398,0,989398
2018,CT,Petroleum,677914,0,677914
2018,CT,Pumped Storage,0,6942,6942
2018,CT,Solar Thermal and Photovoltaic,0,211110,211110
2018,CT,Total,0,78907103,78907103
2018,CT,Wind,0,24590,24590
2018,CT,Wood and Wood Derived Fuels,521742,0,521742
2018,DC,Natural Gas,45540,0,45540
2018,DC,Other Biomass,113122,0,113122
2018,DC,Petroleum,0,0,0
2018,DC,Total,0,158662,158662
2018,DE,Coal,546776,0,546776
2018,DE,Natural Gas,10800310,0,10800310
2018,DE,Other Biomass,118202,0,118202
2018,DE,Other Gases,504360,0,504360
2018,DE,Petroleum,401649,0,401649
2018,DE,Solar Thermal and Photovoltaic,0,99578,99578
2018,DE,Total,0,12481288,12481288
2018,DE,Wind,0,10414,10414
2018,FL,Coal,60544401,0,60544401
2018,FL,Hydroelectric Conventional,0,465148,465148
2018,FL,Natural Gas,343744428,0,343744428
2018,FL,Nuclear,0,58624698,58624698
2018,FL,Other,5966639,0,5966639
2018,FL,Other Biomass,5137975,0,5137975
2018,FL,Other Gases,10976,0,10976
2018,FL,Petroleum,4154716,0,4154716
2018,FL,Solar Thermal and Photovoltaic,0,4824126,4824126
2018,FL,Total,0,488504071,488504071
2018,FL,Wood and Wood Derived Fuels,5030960,0,5030960
2018,GA,Coal,64361110,0,64361110
2018,GA,Hydroelectric Conventional,0,7393736,7393736
2018,GA,Natural Gas,103944220,0,103944220
2018,GA,Nuclear,0,68725352,68725352
2018,GA,Other,171578,0,171578
2018,GA,Other Biomass,681876,0,681876
2018,GA,Petroleum,871468,0,871468
2018,GA,Pumped Storage,0,-977508,-977508
2018,GA,Solar Thermal and Photovoltaic,0,3991674,3991674
2018,GA,Total,0,258478742,258478742
2018,GA,Wood and Wood Derived Fuels,9315239,0,9315239
2018,HI,Coal,2622406,0,2622406
2018,HI,Geothermal,220178,0,220178
2018,HI,Hydroelectric Conventional,0,193040,193040
2018,HI,Other,764538,0,764538
2018,HI,Other Biomass,611025,0,611025
2018,HI,Other Gases,111444,0,111444
2018,HI,Petroleum,13497894,0,13497894
2018,HI,Solar Thermal and Photovoltaic,0,369152,369152
2018,HI,Total,0,19593546,19593546
2018,HI,Wind,0,1203868,1203868
2018,HI,Wood and Wood Derived Fuels,0,0,0
2018,IA,Coal,57105997,0,57105997
2018,IA,Hydroelectric Conventional,0,1849722,1849722
2018,IA,Natural Gas,14680140,0,14680140
2018,IA,Nuclear,0,9790798,9790798
2018,IA,Other,0,0,0
2018,IA,Other Biomass,418353,0,418353
2018,IA,Petroleum,221130,0,221130
2018,IA,Solar Thermal and Photovoltaic,0,22912,22912
2018,IA,Total,0,126761138,126761138
2018,IA,Wind,0,42668114,42668114
2018,IA,Wood and Wood Derived Fuels,3972,0,3972
2018,ID,Coal,40676,0,40676
2018,ID,Geothermal,166224,0,166224
2018,ID,Hydroelectric Conventional,0,22048684,22048684
2018,ID,Natural Gas,6557484,0,6557484
2018,ID,Other,127944,0,127944
2018,ID,Other Biomass,192606,0,192606
2018,ID,Petroleum,114,0,114
2018,ID,Solar Thermal and Photovoltaic,0,1111928,1111928
2018,ID,Total,0,36344240,36344240
2018,ID,Wind,0,5310104,5310104
2018,ID,Wood and Wood Derived Fuels,788474,0,788474
2018,IL,Coal,119283848,0,119283848
2018,IL,Hydroelectric Conventional,0,293056,293056
2018,IL,Natural Gas,34481838,0,34481838
2018,IL,Nuclear,0,196203054,196203054
2018,IL,Other,454256,0,454256
2018,IL,Other Biomass,852742,0,852742
2018,IL,Other Gases,401632,0,401632
2018,IL,Petroleum,106222,0,106222
2018,IL,Solar Thermal and Photovoltaic,0,132100,132100
2018,IL,Total,0,376006714,376006714
2018,IL,Wind,0,23797968,23797968
2018,IL,Wood and Wood Derived Fuels,0,0,0
2018,IN,Coal,154910458,0,154910458
2018,IN,Hydroelectric Conventional,0,445322,445322
2018,IN,Natural Gas,53633989,0,53633989
2018,IN,Other,641276,0,641276
2018,IN,Other Biomass,919778,0,919778
2018,IN,Other Gases,4651626,0,4651626
2018,IN,Petroleum,261234,0,261234
2018,IN,Solar Thermal and Photovoltaic,0,581434,581434
2018,IN,Total,0,226919421,226919421
2018,IN,Wind,0,10874306,10874306
2018,IN,Wood and Wood Derived Fuels,0,0,0
2018,KS,Coal,40947966,0,40947966
2018,KS,Hydroelectric Conventional,0,52840,52840
2018,KS,Natural Gas,6011430,0,6011430
2018,KS,Nuclear,0,18336578,18336578
2018,KS,Other,10020,0,10020
2018,KS,Other Biomass,127102,0,127102
2018,KS,Petroleum,104032,0,104032
2018,KS,Solar Thermal and Photovoltaic,0,15454,15454
2018,KS,Total,0,103420426,103420426
2018,KS,Wind,0,37815004,37815004
2018,KY,Coal,118336286,0,118336286
2018,KY,Hydroelectric Conventional,0,8835666,8835666
2018,KY,Natural Gas,29229998,0,29229998
2018,KY,Other,127080,0,127080
2018,KY,Other Biomass,203134,0,203134
2018,KY,Petroleum,139984,0,139984
2018,KY,Solar Thermal and Photovoltaic,0,78872,78872
2018,KY,Total,0,157608994,157608994
2018,KY,Wood and Wood Derived Fuels,657974,0,657974
2018,LA,Coal,23573448,0,23573448
2018,LA,Hydroelectric Conventional,0,2359710,2359710
2018,LA,Natural Gas,123563547,0,123563547
2018,LA,Nuclear,0,34305164,34305164
2018,LA,Other,1286252,0,1286252
2018,LA,Other Biomass,157574,0,157574
2018,LA,Other Gases,5195916,0,5195916
2018,LA,Petroleum,8755589,0,8755589
2018,LA,Solar Thermal and Photovoltaic,0,3036,3036
2018,LA,Total,0,204256969,204256969
2018,LA,Wood and Wood Derived Fuels,5056732,0,5056732
2018,MA,Coal,0,0,0
2018,MA,Hydroelectric Conventional,0,2267240,2267240
2018,MA,Natural Gas,36771643,0,36771643
2018,MA,Nuclear,0,8883126,8883126
2018,MA,Other,1692828,0,1692828
2018,MA,Other Biomass,2124391,0,2124391
2018,MA,Petroleum,921432,0,921432
2018,MA,Pumped Storage,0,-927566,-927566
2018,MA,Solar Thermal and Photovoltaic,0,1956623,1956623
2018,MA,Total,0,54345765,54345765
2018,MA,Wind,0,441965,441965
2018,MA,Wood and Wood Derived Fuels,214082,0,214082
2018,MD,Coal,20133847,0,20133847
2018,MD,Hydroelectric Conventional,0,5661772,5661772
2018,MD,Natural Gas,27699345,0,27699345
2018,MD,Nuclear,0,29975862,29975862
2018,MD,Other,652254,0,652254
2018,MD,Other Biomass,834693,0,834693
2018,MD,Petroleum,520030,0,520030
2018,MD,Solar Thermal and Photovoltaic,0,793440,793440
2018,MD,Total,0,87619296,87619296
2018,MD,Wind,0,1139968,1139968
2018,MD,Wood and Wood Derived Fuels,208086,0,208086
2018,ME,Coal,141655,0,141655
2018,ME,Hydroelectric Conventional,0,6522108,6522108
2018,ME,Natural Gas,4661434,0,4661434
2018,ME,Other,741687,0,741687
2018,ME,Other Biomass,304858,0,304858
2018,ME,Petroleum,378214,0,378214
2018,ME,Solar Thermal and Photovoltaic,0,24064,24064
2018,ME,Total,0,22561400,22561400
2018,ME,Wind,0,4768590,4768590
2018,ME,Wood and Wood Derived Fuels,5018791,0,5018791
2018,MI,Coal,84661728,0,84661728
2018,MI,Hydroelectric Conventional,0,3138398,3138398
2018,MI,Natural Gas,61973783,0,61973783
2018,MI,Nuclear,0,60957388,60957388
2018,MI,Other,504625,0,504625
2018,MI,Other Biomass,1914934,0,1914934
2018,MI,Other Gases,3195274,0,3195274
2018,MI,Petroleum,2427023,0,2427023
2018,MI,Pumped Storage,0,-1396910,-1396910
2018,MI,Solar Thermal and Photovoltaic,0,236306,236306
2018,MI,Total,0,231674190,231674190
2018,MI,Wind,0,10914504,10914504
2018,MI,Wood and Wood Derived Fuels,3147135,0,3147135
2018,MN,Coal,46910712,0,46910712
2018,MN,Hydroelectric Conventional,0,2107008,2107008
2018,MN,Natural Gas,17110588,0,17110588
2018,MN,Nuclear,0,29202658,29202658
2018,MN,Other,810361,0,810361
2018,MN,Other Biomass,1062466,0,1062466
2018,MN,Petroleum,93148,0,93148
2018,MN,Solar Thermal and Photovoltaic,0,2084042,2084042
2018,MN,Total,0,123034883,123034883
2018,MN,Wind,0,21427300,21427300
2018,MN,Wood and Wood Derived Fuels,2226600,0,2226600
2018,MO,Coal,126710270,0,126710270
2018,MO,Hydroelectric Conventional,0,1656784,1656784
2018,MO,Natural Gas,14100111,0,14100111
2018,MO,Nuclear,0,21310558,21310558
2018,MO,Other,2016,0,2016
2018,MO,Other Biomass,163860,0,163860
2018,MO,Petroleum,199510,0,199510
2018,MO,Pumped Storage,0,93814,93814
2018,MO,Solar Thermal and Photovoltaic,0,182462,182462
2018,MO,Total,0,170190768,170190768
2018,MO,Wind,0,5669354,5669354
2018,MO,Wood and Wood Derived Fuels,102030,0,102030
2018,MS,Coal,10560086,0,10560086
2018,MS,Natural Gas,98963622,0,98963622
2018,MS,Nuclear,0,13838940,13838940
2018,MS,Other,0,0,0
2018,MS,Other Biomass,33108,0,33108
2018,MS,Petroleum,54620,0,54620
2018,MS,Solar Thermal and Photovoltaic,0,651706,651706
2018,MS,Total,0,126947542,126947542
2018,MS,Wood and Wood Derived Fuels,2845462,0,2845462
2018,MT,Coal,26720052,0,26720052
2018,MT,Hydroelectric Conventional,0,22809218,22809218
2018,MT,Natural Gas,952740,0,952740
2018,MT,Other,609344,0,609344
2018,MT,Other Gases,24830,0,24830
2018,MT,Petroleum,892008,0,892008
2018,MT,Solar Thermal and Photovoltaic,0,68024,68024
2018,MT,Total,0,56425662,56425662
2018,MT,Wind,0,4306784,4306784
2018,MT,Wood and Wood Derived Fuels,42662,0,42662
2018,NC,Coal,63380938,0,63380938
2018,NC,Hydroelectric Conventional,0,13210858,13210858
2018,NC,Natural Gas,86891498,0,86891498
2018,NC,Nuclear,0,84153898,84153898
2018,NC,Other,1070112,0,1070112
2018,NC,Other Biomass,1312689,0,1312689
2018,NC,Petroleum,1266162,0,1266162
2018,NC,Pumped Storage,0,0,0
2018,NC,Solar Thermal and Photovoltaic,0,12220756,12220756
2018,NC,Total,0,268498994,268498994
2018,NC,Wind,0,1085544,1085544
2018,NC,Wood and Wood Derived Fuels,3906538,0,3906538
2018,ND,Coal,55081330,0,55081330
2018,ND,Hydroelectric Conventional,0,6360308,6360308
2018,ND,Natural Gas,2038546,0,2038546
2018,ND,Other,103894,0,103894
2018,ND,Other Biomass,2076,0,2076
2018,ND,Other Gases,101976,0,101976
2018,ND,Petroleum,76686,0,76686
2018,ND,Total,0,85230642,85230642
2018,ND,Wind,0,21465826,21465826
2018,NE,Coal,46610416,0,46610416
2018,NE,Hydroelectric Conventional,0,2764146,2764146
2018,NE,Natural Gas,1929580,0,1929580
2018,NE,Nuclear,0,11264280,11264280
2018,NE,Other,0,0,0
2018,NE,Other Biomass,186626,0,186626
2018,NE,Petroleum,24948,0,24948
2018,NE,Solar Thermal and Photovoltaic,0,54224,54224
2018,NE,Total,0,73932432,73932432
2018,NE,Wind,0,11098212,11098212
2018,NE,Wood and Wood Derived Fuels,0,0,0
2018,NH,Coal,1320614,0,1320614
2018,NH,Hydroelectric Conventional,0,2709976,2709976
2018,NH,Natural Gas,5983078,0,5983078
2018,NH,Nuclear,0,20123392,20123392
2018,NH,Other,95354,0,95354
2018,NH,Other Biomass,276909,0,276909
2018,NH,Petroleum,356160,0,356160
2018,NH,Total,0,34174312,34174312
2018,NH,Wind,0,813318,813318
2018,NH,Wood and Wood Derived Fuels,2495510,0,2495510
2018,NJ,Coal,2386576,0,2386576
2018,NJ,Hydroelectric Conventional,0,71076,71076
2018,NJ,Natural Gas,77726983,0,77726983
2018,NJ,Nuclear,0,63964212,63964212
2018,NJ,Other,1103838,0,1103838
2018,NJ,Other Biomass,1869862,0,1869862
2018,NJ,Other Gases,424096,0,424096
2018,NJ,Petroleum,724729,0,724729
2018,NJ,Pumped Storage,0,-230204,-230204
2018,NJ,Solar Thermal and Photovoltaic,0,1980840,1980840
2018,NJ,Total,0,150067199,150067199
2018,NJ,Wind,0,45192,45192
2018,NM,Coal,26803064,0,26803064
2018,NM,Geothermal,26276,0,26276
2018,NM,Hydroelectric Conventional,0,299092,299092
2018,NM,Natural Gas,23256354,0,23256354
2018,NM,Other,-1462,0,-1462
2018,NM,Other Biomass,42312,0,42312
2018,NM,Petroleum,41474,0,41474
2018,NM,Solar Thermal and Photovoltaic,0,2697152,2697152
2018,NM,Total,0,65347364,65347364
2018,NM,Wind,0,12183102,12183102
2018,NV,Coal,4970092,0,4970092
2018,NV,Geothermal,6923964,0,6923964
2018,NV,Hydroelectric Conventional,0,3762532,3762532
2018,NV,Natural Gas,53377223,0,53377223
2018,NV,Other,57564,0,57564
2018,NV,Other Biomass,106132,0,106132
2018,NV,Other Gases,0,0,0
2018,NV,Petroleum,20490,0,20490
2018,NV,Solar Thermal and Photovoltaic,0,9437790,9437790
2018,NV,Total,0,79280482,79280482
2018,NV,Wind,0,624696,624696
2018,NY,Coal,1380771,0,1380771
2018,NY,Hydroelectric Conventional,0,59260000,59260000
2018,NY,Natural Gas,101620853,0,101620853
2018,NY,Nuclear,0,85838022,85838022
2018,NY,Other,1746290,0,1746290
2018,NY,Other Biomass,3231934,0,3231934
2018,NY,Other Gases,0,0,0
2018,NY,Petroleum,3181421,0,3181421
2018,NY,Pumped Storage,0,-861436,-861436
2018,NY,Solar Thermal and Photovoltaic,0,594944,594944
2018,NY,Total,0,265041001,265041001
2018,NY,Wind,0,7996666,7996666
2018,NY,Wood and Wood Derived Fuels,1051536,0,1051536
2018,OH,Coal,117453925,0,117453925
2018,OH,Hydroelectric Conventional,0,488038,488038
2018,OH,Natural Gas,88429003,0,88429003
2018,OH,Nuclear,0,36630014,36630014
2018,OH,Other,10866,0,10866
2018,OH,Other Biomass,945194,0,945194
2018,OH,Other Gases,1573781,0,1573781
2018,OH,Petroleum,2631493,0,2631493
2018,OH,Solar Thermal and Photovoltaic,0,238110,238110
2018,OH,Total,0,252369220,252369220
2018,OH,Wind,0,3500044,3500044
2018,OH,Wood and Wood Derived Fuels,468754,0,468754
2018,OK,Coal,29813494,0,29813494
2018,OK,Hydroelectric Conventional,0,4069794,4069794
2018,OK,Natural Gas,83225972,0,83225972
2018,OK,Other,114150,0,114150
2018,OK,Other Biomass,153690,0,153690
2018,OK,Petroleum,35955,0,35955
2018,OK,Pumped Storage,0,-270102,-270102
2018,OK,Solar Thermal and Photovoltaic,0,123252,123252
2018,OK,Total,0,172447442,172447442
2018,OK,Wind,0,54676456,54676456
2018,OK,Wood and Wood Derived Fuels,504780,0,504780
2018,OR,Coal,2952782,0,2952782
2018,OR,Geothermal,352470,0,352470
2018,OR,Hydroelectric Conventional,0,70885546,70885546
2018,OR,Natural Gas,35845554,0,35845554
2018,OR,Other,68190,0,68190
2018,OR,Other Biomass,714145,0,714145
2018,OR,Petroleum,9712,0,9712
2018,OR,Solar Thermal and Photovoltaic,0,1143392,1143392
2018,OR,Total,0,128227120,128227120
2018,OR,Wind,0,14894884,14894884
2018,OR,Wood and Wood Derived Fuels,1360446,0,1360446
2018,PA,Coal,88172568,0,88172568
2018,PA,Hydroelectric Conventional,0,8523514,8523514
2018,PA,Natural Gas,152781718,0,152781718
2018,PA,Nuclear,0,166953488,166953488
2018,PA,Other,1561694,0,1561694
2018,PA,Other Biomass,3633364,0,3633364
2018,PA,Other Gases,1056985,0,1056985
2018,PA,Petroleum,1251294,0,1251294
2018,PA,Pumped Storage,0,-1318286,-1318286
2018,PA,Solar Thermal and Photovoltaic,0,124950,124950
2018,PA,Total,0,430771660,430771660
2018,PA,Wind,0,7133834,7133834
2018,PA,Wood and Wood Derived Fuels,896538,0,896538
2018,RI,Coal,0,0,0
2018,RI,Hydroelectric Conventional,0,8200,8200
2018,RI,Natural Gas,15793879,0,15793879
2018,RI,Other Biomass,422062,0,422062
2018,RI,Petroleum,151428,0,151428
2018,RI,Solar Thermal and Photovoltaic,0,57732,57732
2018,RI,Total,0,16750514,16750514
2018,RI,Wind,0,317212,317212
2018,SC,Coal,38994969,0,38994969
2018,SC,Hydroelectric Conventional,0,6027440,6027440
2018,SC,Natural Gas,43307592,0,43307592
2018,SC,Nuclear,0,105432938,105432938
2018,SC,Other,83302,0,83302
2018,SC,Other Biomass,299712,0,299712
2018,SC,Petroleum,687806,0,687806
2018,SC,Pumped Storage,0,-1409470,-1409470
2018,SC,Solar Thermal and Photovoltaic,0,1020988,1020988
2018,SC,Total,0,198728176,198728176
2018,SC,Wood and Wood Derived Fuels,4282900,0,4282900
2018,SD,Coal,4678674,0,4678674
2018,SD,Hydroelectric Conventional,0,12532540,12532540
2018,SD,Natural Gas,2335438,0,2335438
2018,SD,Other,0,0,0
2018,SD,Other Biomass,0,0,0
2018,SD,Petroleum,12793,0,12793
2018,SD,Solar Thermal and Photovoltaic,0,3344,3344
2018,SD,Total,0,25232792,25232792
2018,SD,Wind,0,5670004,5670004
2018,TN,Coal,41933426,0,41933426
2018,TN,Hydroelectric Conventional,0,20585450,20585450
2018,TN,Natural Gas,26797406,0,26797406
2018,TN,Nuclear,0,72352764,72352764
2018,TN,Other,16914,0,16914
2018,TN,Other Biomass,174440,0,174440
2018,TN,Other Gases,22350,0,22350
2018,TN,Petroleum,259110,0,259110
2018,TN,Pumped Storage,0,-1239688,-1239688
2018,TN,Solar Thermal and Photovoltaic,0,335188,335188
2018,TN,Total,0,163109834,163109834
2018,TN,Wind,0,82018,82018
2018,TN,Wood and Wood Derived Fuels,1790454,0,1790454
2018,TX,Coal,223445285,0,223445285
2018,TX,Hydroelectric Conventional,0,2252756,2252756
2018,TX,Natural Gas,479426169,0,479426169
2018,TX,Nuclear,0,82371478,82371478
2018,TX,Other,905258,0,905258
2018,TX,Other Biomass,1170417,0,1170417
2018,TX,Other Gases,5052952,0,5052952
2018,TX,Petroleum,258625,0,258625
2018,TX,Solar Thermal and Photovoltaic,0,6411294,6411294
2018,TX,Total,0,954704850,954704850
2018,TX,Wind,0,151400868,151400868
2018,TX,Wood and Wood Derived Fuels,2009748,0,2009748
2018,UT,Coal,51824948,0,51824948
2018,UT,Geothermal,891474,0,891474
2018,UT,Hydroelectric Conventional,0,1854194,1854194
2018,UT,Natural Gas,17448238,0,17448238
2018,UT,Other,450286,0,450286
2018,UT,Other Biomass,158920,0,158920
2018,UT,Other Gases,13118,0,13118
2018,UT,Petroleum,73147,0,73147
2018,UT,Solar Thermal and Photovoltaic,0,4447412,4447412
2018,UT,Total,0,78750848,78750848
2018,UT,Wind,0,1589110,1589110
2018,VA,Coal,18532551,0,18532551
2018,VA,Hydroelectric Conventional,0,3529720,3529720
2018,VA,Natural Gas,100320601,0,100320601
2018,VA,Nuclear,0,58503336,58503336
2018,VA,Other,942454,0,942454
2018,VA,Other Biomass,2344030,0,2344030
2018,VA,Petroleum,1900823,0,1900823
2018,VA,Pumped Storage,0,-2583952,-2583952
2018,VA,Solar Thermal and Photovoltaic,0,1526144,1526144
2018,VA,Total,0,191018242,191018242
2018,VA,Wood and Wood Derived Fuels,6002534,0,6002534
2018,VT,Hydroelectric Conventional,0,2536378,2536378
2018,VT,Natural Gas,3594,0,3594
2018,VT,Other,-592,0,-592
2018,VT,Other Biomass,24106,0,24106
2018,VT,Petroleum,6264,0,6264
2018,VT,Solar Thermal and Photovoltaic,0,213480,213480
2018,VT,Total,0,4357830,4357830
2018,VT,Wind,0,746692,746692
2018,VT,Wood and Wood Derived Fuels,827910,0,827910
2018,WA,Coal,10765732,0,10765732
2018,WA,Hydroelectric Conventional,0,161766754,161766754
2018,WA,Natural Gas,21070156,0,21070156
2018,WA,Nuclear,0,19416882,19416882
2018,WA,Other,118530,0,118530
2018,WA,Other Biomass,463414,0,463414
2018,WA,Other Gases,861680,0,861680
2018,WA,Petroleum,47312,0,47312
2018,WA,Pumped Storage,0,56474,56474
2018,WA,Solar Thermal and Photovoltaic,0,3390,3390
2018,WA,Total,0,233513457,233513457
2018,WA,Wind,0,15800188,15800188
2018,WA,Wood and Wood Derived Fuels,3142944,0,3142944
2018,WI,Coal,66644759,0,66644759
2018,WI,Hydroelectric Conventional,0,4784019,4784019
2018,WI,Natural Gas,33597311,0,33597311
2018,WI,Nuclear,0,20258244,20258244
2018,WI,Other,85262,0,85262
2018,WI,Other Biomass,1108078,0,1108078
2018,WI,Petroleum,275022,0,275022
2018,WI,Solar Thermal and Photovoltaic,0,79364,79364
2018,WI,Total,0,131873607,131873607
2018,WI,Wind,0,3275316,3275316
2018,WI,Wood and Wood Derived Fuels,1766230,0,1766230
2018,WV,Coal,124077671,0,124077671
2018,WV,Hydroelectric Conventional,0,3695286,3695286
2018,WV,Natural Gas,2840780,0,2840780
2018,WV,Other,-23116,0,-23116
2018,WV,Other Gases,49690,0,49690
2018,WV,Petroleum,317770,0,317770
2018,WV,Total,0,134498050,134498050
2018,WV,Wind,0,3539968,3539968
2018,WY,Coal,79358573,0,79358573
2018,WY,Hydroelectric Conventional,0,1951404,1951404
2018,WY,Natural Gas,1792244,0,1792244
2018,WY,Other,170532,0,170532
2018,WY,Other Gases,755282,0,755282
2018,WY,Petroleum,80271,0,80271
2018,WY,Solar Thermal and Photovoltaic,0,1648,1648
2018,WY,Total,0,92224272,92224272
2018,WY,Wind,0,8114316,8114316